project_name,bug_id,tool,num_tests,num_failing_tests,num_passing_tests
Chart,1,developer,428,1,427
Chart,2,developer,349,2,347
Chart,3,developer,49,1,48
Chart,4,developer,425,22,403
Chart,5,developer,126,1,125
Chart,6,developer,479,2,477
Chart,7,developer,15,1,14
Chart,8,developer,23,1,22
Chart,9,developer,32,1,31
Chart,10,developer,1,1,0
Chart,11,developer,264,1,263
Chart,12,developer,200,1,199
Chart,13,developer,139,1,138
Chart,14,developer,491,4,487
Chart,15,developer,197,1,196
Chart,16,developer,21,8,13
Chart,17,developer,49,1,48
Chart,18,developer,241,4,237
Chart,19,developer,361,2,359
Chart,20,developer,296,1,295
Chart,21,developer,13,1,12
Chart,22,developer,37,6,31
Chart,23,developer,5,1,4
Chart,24,developer,10,1,9
Chart,25,developer,9,4,5
Chart,26,developer,539,22,517
Chart,200154,developer,349,6,343
Chart,200157,developer,349,2,347
Chart,200158,developer,349,1,348
Chart,200159,developer,349,1,348
Chart,200160,developer,349,1,348
Chart,200164,developer,349,1,348
Chart,200167,developer,349,1,348
Chart,200320,developer,349,7,342
Chart,200323,developer,349,4,345
Chart,200324,developer,349,1,348
Chart,200325,developer,349,1,348
Chart,200326,developer,349,1,348
Chart,200330,developer,349,1,348
Chart,300265,developer,49,1,48
Chart,300266,developer,49,1,48
Chart,400483,developer,425,22,403
Chart,500080,developer,126,2,124
Chart,500081,developer,126,2,124
Chart,500082,developer,126,2,124
Chart,500084,developer,126,1,125
Chart,500085,developer,126,1,125
Chart,500086,developer,126,1,125
Chart,500087,developer,126,1,125
Chart,500088,developer,126,1,125
Chart,600004,developer,479,5,474
Chart,600005,developer,479,3,476
Chart,600006,developer,479,2,477
Chart,600007,developer,479,5,474
Chart,600008,developer,479,3,476
Chart,600009,developer,479,3,476
Chart,600010,developer,479,223,256
Chart,900243,developer,32,1,31
Chart,900244,developer,32,1,31
Chart,900245,developer,32,1,31
Chart,900246,developer,32,1,31
Chart,900247,developer,32,1,31
Chart,900248,developer,32,1,31
Chart,900249,developer,32,1,31
Chart,900250,developer,32,1,31
Chart,900251,developer,32,1,31
Chart,1100044,developer,264,16,248
Chart,1200001,developer,200,1,199
Chart,1300227,developer,139,1,138
Chart,1300228,developer,139,1,138
Chart,1300229,developer,139,1,138
Chart,1300230,developer,139,1,138
Chart,1400231,developer,491,1,490
Chart,1400232,developer,491,1,490
Chart,1400264,developer,491,1,490
Chart,1400265,developer,491,1,490
Chart,1400751,developer,491,1,490
Chart,1400752,developer,491,1,490
Chart,1400778,developer,491,1,490
Chart,1400779,developer,491,1,490
Chart,1600017,developer,21,1,20
Chart,1600018,developer,21,14,7
Chart,1600019,developer,21,3,18
Chart,1600020,developer,21,3,18
Chart,1600021,developer,21,14,7
Chart,1600022,developer,21,5,16
Chart,1600044,developer,21,1,20
Chart,1700178,developer,49,3,46
Chart,1700179,developer,49,3,46
Chart,1800107,developer,241,2,239
Chart,1800108,developer,241,1,240
Chart,1800111,developer,241,2,239
Chart,1800112,developer,241,2,239
Chart,1800113,developer,241,2,239
Chart,1800202,developer,241,4,237
Chart,1900077,developer,361,1,360
Chart,1900112,developer,361,1,360
Chart,2100062,developer,13,2,11
Chart,2100063,developer,13,2,11
Chart,2100064,developer,13,2,11
Chart,2100065,developer,13,2,11
Chart,2100066,developer,13,2,11
Chart,2100067,developer,13,2,11
Chart,2100068,developer,13,2,11
Chart,2100069,developer,13,2,11
Chart,2100070,developer,13,2,11
Chart,2100071,developer,13,2,11
Chart,2100072,developer,13,2,11
Chart,2100073,developer,13,2,11
Chart,2100074,developer,13,1,12
Chart,2100075,developer,13,2,11
Chart,2100076,developer,13,1,12
Chart,2100077,developer,13,2,11
Chart,2100078,developer,13,1,12
Chart,2100079,developer,13,1,12
Chart,2100080,developer,13,2,11
Chart,2100081,developer,13,2,11
Chart,2100082,developer,13,2,11
Chart,2100083,developer,13,1,12
Chart,2100084,developer,13,2,11
Chart,2100085,developer,13,1,12
Chart,2100086,developer,13,2,11
Chart,2200034,developer,37,5,32
Chart,2200035,developer,37,2,35
Chart,2200036,developer,37,5,32
Chart,2200037,developer,37,2,35
Chart,2200038,developer,37,5,32
Chart,2200039,developer,37,2,35
Chart,2200040,developer,37,5,32
Chart,2200068,developer,37,1,36
Chart,2200069,developer,37,1,36
Chart,2200070,developer,37,1,36
Chart,2200071,developer,37,1,36
Chart,2200072,developer,37,1,36
Chart,2200073,developer,37,1,36
Chart,2200074,developer,37,1,36
Chart,2200075,developer,37,1,36
Chart,2200076,developer,37,1,36
Chart,2200077,developer,37,1,36
Chart,2200078,developer,37,1,36
Chart,2200079,developer,37,1,36
Chart,2200080,developer,37,1,36
Chart,2200081,developer,37,1,36
Chart,2200082,developer,37,1,36
Chart,2200086,developer,37,1,36
Chart,2200087,developer,37,1,36
Chart,2200088,developer,37,1,36
Chart,2200100,developer,37,2,35
Chart,2200101,developer,37,2,35
Chart,2200102,developer,37,2,35
Chart,2300009,developer,5,4,1
Chart,2300010,developer,5,1,4
Chart,2300011,developer,5,1,4
Chart,2300012,developer,5,4,1
Chart,2300013,developer,5,1,4
Chart,2300014,developer,5,4,1
Chart,2300015,developer,5,1,4
Chart,2300016,developer,5,1,4
Chart,2300017,developer,5,4,1
Chart,2300018,developer,5,1,4
Chart,2300019,developer,5,1,4
Chart,2300020,developer,5,4,1
Chart,2400011,developer,10,1,9
Chart,2400012,developer,10,1,9
Chart,2400013,developer,10,1,9
Chart,2400014,developer,10,1,9
Chart,2400015,developer,10,1,9
Chart,2400016,developer,10,1,9
Chart,2400017,developer,10,1,9
Chart,2400018,developer,10,1,9
Chart,2400019,developer,10,1,9
Chart,2400020,developer,10,1,9
Chart,2400021,developer,10,1,9
Chart,2400022,developer,10,1,9
Chart,2400023,developer,10,1,9
Chart,2400024,developer,10,1,9
Chart,2400025,developer,10,1,9
Chart,2500004,developer,9,1,8
Chart,2500005,developer,9,1,8
Chart,2500007,developer,9,1,8
Chart,2500011,developer,9,1,8
Chart,2500012,developer,9,1,8
Chart,2500014,developer,9,1,8
Chart,2600120,developer,539,22,517
Closure,1,developer,374,8,366
Closure,2,developer,6758,1,6757
Closure,3,developer,358,3,355
Closure,4,developer,6883,3,6880
Closure,5,developer,314,1,313
Closure,6,developer,6674,3,6671
Closure,7,developer,6648,2,6646
Closure,8,developer,282,1,281
Closure,9,developer,117,1,116
Closure,10,developer,6516,1,6515
Closure,11,developer,6586,2,6584
Closure,12,developer,351,1,350
Closure,13,developer,608,1,607
Closure,14,developer,3339,3,3336
Closure,15,developer,333,1,332
Closure,16,developer,390,2,388
Closure,17,developer,6539,1,6538
Closure,18,developer,6541,1,6540
Closure,19,developer,6538,1,6537
Closure,20,developer,369,1,368
Closure,21,developer,6529,1,6528
Closure,22,developer,6529,1,6528
Closure,23,developer,372,1,371
Closure,24,developer,380,1,379
Closure,25,developer,2896,1,2895
Closure,26,developer,6489,7,6482
Closure,27,developer,6849,3,6846
Closure,28,developer,671,2,669
Closure,29,developer,291,5,286
Closure,30,developer,337,3,334
Closure,31,developer,6438,1,6437
Closure,32,developer,5082,4,5078
Closure,33,developer,7221,1,7220
Closure,34,developer,4012,1,4011
Closure,35,developer,2821,1,2820
Closure,36,developer,384,1,383
Closure,37,developer,6543,1,6542
Closure,38,developer,4007,1,4006
Closure,39,developer,7113,2,7111
Closure,40,developer,522,2,520
Closure,41,developer,6362,3,6359
Closure,42,developer,6252,1,6251
Closure,43,developer,6221,2,6219
Closure,44,developer,3831,1,3830
Closure,45,developer,177,1,176
Closure,46,developer,3217,3,3214
Closure,47,developer,6218,16,6202
Closure,48,developer,6196,1,6195
Closure,49,developer,1841,66,1775
Closure,50,developer,101,2,99
Closure,51,developer,3823,1,3822
Closure,52,developer,3803,1,3802
Closure,53,developer,116,1,115
Closure,54,developer,6965,3,6962
Closure,55,developer,96,1,95
Closure,56,developer,6086,3,6083
Closure,57,developer,6063,1,6062
Closure,58,developer,177,1,176
Closure,59,developer,6042,1,6041
Closure,60,developer,5994,2,5992
Closure,61,developer,5987,3,5984
Closure,62,developer,6023,2,6021
Closure,63,developer,6023,2,6021
Closure,64,developer,6004,1,6003
Closure,65,developer,3732,1,3731
Closure,66,developer,5985,2,5983
Closure,67,developer,134,1,133
Closure,68,developer,4595,1,4594
Closure,69,developer,5985,3,5982
Closure,70,developer,5968,5,5963
Closure,71,developer,5924,2,5922
Closure,72,developer,420,1,419
Closure,73,developer,3600,1,3599
Closure,74,developer,170,3,167
Closure,75,developer,5764,1,5763
Closure,76,developer,107,4,103
Closure,77,developer,3476,1,3475
Closure,78,developer,156,1,155
Closure,79,developer,5675,5,5670
Closure,80,developer,5634,2,5632
Closure,81,developer,5697,1,5696
Closure,82,developer,6358,2,6356
Closure,83,developer,53,1,52
Closure,84,developer,5543,1,5542
Closure,85,developer,77,2,75
Closure,86,developer,5374,7,5367
Closure,87,developer,112,1,111
Closure,88,developer,92,7,85
Closure,89,developer,443,8,435
Closure,90,developer,6033,2,6031
Closure,91,developer,96,1,95
Closure,92,developer,1807,1,1806
Closure,93,developer,1800,1,1799
Closure,94,developer,5157,3,5154
Closure,95,developer,2285,2,2283
Closure,96,developer,5083,1,5082
Closure,97,developer,82,1,81
Closure,98,developer,373,1,372
Closure,99,developer,75,3,72
Closure,100,developer,71,9,62
Closure,101,developer,21,1,20
Closure,102,developer,778,1,777
Closure,103,developer,1488,3,1485
Closure,104,developer,4350,1,4349
Closure,105,developer,106,1,105
Closure,106,developer,1209,4,1205
Closure,107,developer,115,1,114
Closure,108,developer,452,1,451
Closure,109,developer,6099,2,6097
Closure,110,developer,8112,2,8110
Closure,111,developer,2498,1,2497
Closure,112,developer,3222,2,3220
Closure,113,developer,2642,1,2641
Closure,114,developer,638,1,637
Closure,115,developer,693,7,686
Closure,116,developer,696,8,688
Closure,117,developer,7149,1,7148
Closure,118,developer,7142,2,7140
Closure,119,developer,912,1,911
Closure,120,developer,7134,1,7133
Closure,121,developer,461,1,460
Closure,122,developer,7167,3,7164
Closure,123,developer,4492,1,4491
Closure,124,developer,316,1,315
Closure,125,developer,7061,1,7060
Closure,126,developer,318,2,316
Closure,127,developer,336,6,330
Closure,128,developer,4283,1,4282
Closure,129,developer,6782,1,6781
Closure,130,developer,577,1,576
Closure,131,developer,2987,2,2985
Closure,132,developer,396,1,395
Closure,133,developer,5493,1,5492
Closure,100127,developer,374,14,360
Closure,100128,developer,374,8,366
Closure,100129,developer,374,8,366
Closure,200620,developer,6758,1,6757
Closure,200621,developer,6758,1,6757
Closure,300031,developer,358,27,331
Closure,300032,developer,358,71,287
Closure,300112,developer,358,3,355
Closure,300113,developer,358,3,355
Closure,300114,developer,358,10,348
Closure,300115,developer,358,3,355
Closure,400024,developer,6883,5,6878
Closure,400025,developer,6883,328,6555
Closure,400032,developer,6883,213,6670
Closure,500041,developer,314,1,313
Closure,500042,developer,314,15,299
Closure,500043,developer,314,1,313
Closure,600101,developer,6674,1,6673
Closure,600105,developer,6674,392,6282
Closure,600106,developer,6674,3,6671
Closure,700063,developer,6648,3,6645
Closure,700064,developer,6648,3,6645
Closure,700065,developer,6648,3,6645
Closure,700066,developer,6648,2,6646
Closure,800061,developer,282,2,280
Closure,800062,developer,282,2,280
Closure,800063,developer,282,2,280
Closure,800064,developer,282,2,280
Closure,800065,developer,282,2,280
Closure,800066,developer,282,2,280
Closure,800067,developer,282,2,280
Closure,800068,developer,282,1,281
Closure,800069,developer,282,2,280
Closure,800070,developer,282,2,280
Closure,800071,developer,282,1,281
Closure,800072,developer,282,2,280
Closure,800073,developer,282,1,281
Closure,900013,developer,117,1,116
Closure,900057,developer,117,9,108
Closure,1000477,developer,6516,18,6498
Closure,1100637,developer,6586,50,6536
Closure,1100638,developer,6586,8,6578
Closure,1200020,developer,351,138,213
Closure,1200021,developer,351,1,350
Closure,1200022,developer,351,1,350
Closure,1300036,developer,608,139,469
Closure,1400295,developer,3339,3,3336
Closure,1500007,developer,333,1,332
Closure,1500008,developer,333,8,325
Closure,1500009,developer,333,1,332
Closure,1600036,developer,390,18,372
Closure,1600038,developer,390,18,372
Closure,1600039,developer,390,18,372
Closure,1600040,developer,390,17,373
Closure,1600207,developer,390,17,373
Closure,1700518,developer,6539,1,6538
Closure,1700519,developer,6539,28,6511
Closure,1700520,developer,6539,28,6511
Closure,1700521,developer,6539,1,6538
Closure,1700522,developer,6539,28,6511
Closure,1700523,developer,6539,9,6530
Closure,1700524,developer,6539,9,6530
Closure,1700525,developer,6539,3,6536
Closure,1700526,developer,6539,9,6530
Closure,1800259,developer,6541,15,6526
Closure,1800260,developer,6541,3,6538
Closure,1900023,developer,6538,1,6537
Closure,2000081,developer,369,1,368
Closure,2000082,developer,369,1,368
Closure,2000083,developer,369,1,368
Closure,2000084,developer,369,1,368
Closure,2000085,developer,369,1,368
Closure,2000086,developer,369,1,368
Closure,2100013,developer,6529,1,6528
Closure,2100014,developer,6529,3,6526
Closure,2100015,developer,6529,11,6518
Closure,2100024,developer,6529,6,6523
Closure,2100025,developer,6529,6,6523
Closure,2100026,developer,6529,3,6526
Closure,2100027,developer,6529,103,6426
Closure,2100028,developer,6529,85,6444
Closure,2100029,developer,6529,11,6518
Closure,2100030,developer,6529,103,6426
Closure,2100031,developer,6529,103,6426
Closure,2200013,developer,6529,1,6528
Closure,2200014,developer,6529,3,6526
Closure,2200015,developer,6529,11,6518
Closure,2200017,developer,6529,4,6525
Closure,2200018,developer,6529,7,6522
Closure,2200019,developer,6529,2,6527
Closure,2200020,developer,6529,4,6525
Closure,2300757,developer,372,1,371
Closure,2300758,developer,372,1,371
Closure,2300759,developer,372,1,371
Closure,2300760,developer,372,1,371
Closure,2300761,developer,372,1,371
Closure,2300762,developer,372,1,371
Closure,2300763,developer,372,1,371
Closure,2400078,developer,380,2,378
Closure,2400079,developer,380,39,341
Closure,2400080,developer,380,2,378
Closure,2400081,developer,380,39,341
Closure,2400082,developer,380,1,379
Closure,2400083,developer,380,2,378
Closure,2400089,developer,380,1,379
Closure,2400090,developer,380,1,379
Closure,2400091,developer,380,1,379
Closure,2400092,developer,380,1,379
Closure,2500549,developer,2896,126,2770
Closure,2500551,developer,2896,109,2787
Closure,2500569,developer,2896,1,2895
Closure,2500571,developer,2896,518,2378
Closure,2600021,developer,6489,9,6480
Closure,2600068,developer,6489,1,6488
Closure,2600069,developer,6489,7,6482
Closure,2600070,developer,6489,7,6482
Closure,2600078,developer,6489,1,6488
Closure,2700016,developer,6849,2,6847
Closure,2700033,developer,6849,2,6847
Closure,2800025,developer,671,5,666
Closure,2900028,developer,291,26,265
Closure,2900041,developer,291,11,280
Closure,2900042,developer,291,14,277
Closure,2900043,developer,291,5,286
Closure,2900044,developer,291,6,285
Closure,2900045,developer,291,5,286
Closure,2900046,developer,291,4,287
Closure,2900047,developer,291,5,286
Closure,2900060,developer,291,13,278
Closure,3000004,developer,337,24,313
Closure,3000098,developer,337,10,327
Closure,3000099,developer,337,81,256
Closure,3000101,developer,337,9,328
Closure,3000102,developer,337,1,336
Closure,3000103,developer,337,1,336
Closure,3000114,developer,337,1,336
Closure,3000115,developer,337,24,313
Closure,3000116,developer,337,1,336
Closure,3000143,developer,337,24,313
Closure,3100236,developer,6438,3,6435
Closure,3100237,developer,6438,13,6425
Closure,3200568,developer,5082,2,5080
Closure,3200569,developer,5082,2,5080
Closure,3200570,developer,5082,2,5080
Closure,3200571,developer,5082,2,5080
Closure,3200572,developer,5082,2,5080
Closure,3200573,developer,5082,2,5080
Closure,3200574,developer,5082,2,5080
Closure,3200581,developer,5082,2,5080
Closure,3200582,developer,5082,4,5078
Closure,3200583,developer,5082,4,5078
Closure,3200589,developer,5082,4,5078
Closure,3200590,developer,5082,4,5078
Closure,3200591,developer,5082,20,5062
Closure,3200592,developer,5082,4,5078
Closure,3200593,developer,5082,4,5078
Closure,3200594,developer,5082,4,5078
Closure,3200595,developer,5082,4,5078
Closure,3200596,developer,5082,8,5074
Closure,3200597,developer,5082,4,5078
Closure,3200598,developer,5082,3,5079
Closure,3200599,developer,5082,2,5080
Closure,3200600,developer,5082,4,5078
Closure,3200601,developer,5082,3,5079
Closure,3200602,developer,5082,5,5077
Closure,3200603,developer,5082,5,5077
Closure,3200604,developer,5082,3,5079
Closure,3200605,developer,5082,5,5077
Closure,3200606,developer,5082,17,5065
Closure,3200607,developer,5082,17,5065
Closure,3200635,developer,5082,22,5060
Closure,3300231,developer,7221,1,7220
Closure,3300232,developer,7221,8,7213
Closure,3300233,developer,7221,1,7220
Closure,3400052,developer,4012,8,4004
Closure,3400053,developer,4012,8,4004
Closure,3400054,developer,4012,9,4003
Closure,3400055,developer,4012,8,4004
Closure,3400056,developer,4012,8,4004
Closure,3400057,developer,4012,8,4004
Closure,3400058,developer,4012,127,3885
Closure,3400601,developer,4012,21,3991
Closure,3400602,developer,4012,117,3895
Closure,3401068,developer,4012,34,3978
Closure,3401069,developer,4012,38,3974
Closure,3401070,developer,4012,38,3974
Closure,3401071,developer,4012,34,3978
Closure,3401072,developer,4012,1,4011
Closure,3401073,developer,4012,34,3978
Closure,3401074,developer,4012,1,4011
Closure,3500574,developer,2821,67,2754
Closure,3500575,developer,2821,8,2813
Closure,3600284,developer,384,6,378
Closure,3600285,developer,384,1,383
Closure,3700114,developer,6543,5157,1386
Closure,3700115,developer,6543,5157,1386
Closure,3700445,developer,6543,5103,1440
Closure,3700446,developer,6543,1,6542
Closure,3700447,developer,6543,1,6542
Closure,3800113,developer,4007,1,4006
Closure,3800114,developer,4007,1,4006
Closure,3800115,developer,4007,1,4006
Closure,3800116,developer,4007,1,4006
Closure,3800117,developer,4007,6,4001
Closure,3800118,developer,4007,2,4005
Closure,3800119,developer,4007,49,3958
Closure,3800120,developer,4007,2,4005
Closure,3800121,developer,4007,7,4000
Closure,3900157,developer,7113,21,7092
Closure,3900159,developer,7113,19,7094
Closure,3900160,developer,7113,2,7111
Closure,3900161,developer,7113,4,7109
Closure,3900162,developer,7113,2,7111
Closure,3900163,developer,7113,19,7094
Closure,3900164,developer,7113,1,7112
Closure,4000121,developer,522,2,520
Closure,4100185,developer,6362,3,6359
Closure,4100186,developer,6362,2435,3927
Closure,4100188,developer,6362,3,6359
Closure,4100190,developer,6362,2435,3927
Closure,4100191,developer,6362,3,6359
Closure,4200207,developer,6252,1,6251
Closure,4200208,developer,6252,77,6175
Closure,4200209,developer,6252,1,6251
Closure,4300131,developer,6221,2489,3732
Closure,4300132,developer,6221,2489,3732
Closure,4300133,developer,6221,8,6213
Closure,4300134,developer,6221,2,6219
Closure,4300135,developer,6221,2489,3732
Closure,4300136,developer,6221,2489,3732
Closure,4300137,developer,6221,2489,3732
Closure,4300138,developer,6221,8,6213
Closure,4300139,developer,6221,2489,3732
Closure,4300140,developer,6221,2,6219
Closure,4300141,developer,6221,8,6213
Closure,4300155,developer,6221,2,6219
Closure,4300156,developer,6221,654,5567
Closure,4300158,developer,6221,654,5567
Closure,4300159,developer,6221,2,6219
Closure,4300161,developer,6221,654,5567
Closure,4300162,developer,6221,8,6213
Closure,4300163,developer,6221,8,6213
Closure,4300164,developer,6221,8,6213
Closure,4400061,developer,3831,2,3829
Closure,4400062,developer,3831,1,3830
Closure,4400063,developer,3831,1,3830
Closure,4400064,developer,3831,29,3802
Closure,4400065,developer,3831,2,3829
Closure,4400066,developer,3831,1,3830
Closure,4400067,developer,3831,236,3595
Closure,4400068,developer,3831,1,3830
Closure,4400069,developer,3831,31,3800
Closure,4400070,developer,3831,2,3829
Closure,4400071,developer,3831,1,3830
Closure,4500292,developer,177,10,167
Closure,4500300,developer,177,1,176
Closure,4500301,developer,177,10,167
Closure,4500302,developer,177,1,176
Closure,4500303,developer,177,1,176
Closure,4500304,developer,177,1,176
Closure,4500305,developer,177,6,171
Closure,4500306,developer,177,10,167
Closure,4500307,developer,177,15,162
Closure,4500308,developer,177,7,170
Closure,4500309,developer,177,45,132
Closure,4500310,developer,177,10,167
Closure,4500375,developer,177,2,175
Closure,4700232,developer,6218,8,6210
Closure,4700233,developer,6218,8,6210
Closure,4700234,developer,6218,8,6210
Closure,4700235,developer,6218,8,6210
Closure,4700236,developer,6218,8,6210
Closure,4700237,developer,6218,8,6210
Closure,4700238,developer,6218,8,6210
Closure,4700239,developer,6218,8,6210
Closure,4700240,developer,6218,8,6210
Closure,4700241,developer,6218,8,6210
Closure,4700242,developer,6218,8,6210
Closure,4700243,developer,6218,8,6210
Closure,4700316,developer,6218,16,6202
Closure,4700317,developer,6218,16,6202
Closure,4700318,developer,6218,11,6207
Closure,4700319,developer,6218,13,6205
Closure,4700320,developer,6218,16,6202
Closure,4700321,developer,6218,24,6194
Closure,4700322,developer,6218,24,6194
Closure,4700323,developer,6218,24,6194
Closure,4700324,developer,6218,37,6181
Closure,4700325,developer,6218,40,6178
Closure,4700326,developer,6218,16,6202
Closure,4700327,developer,6218,48,6170
Closure,4700328,developer,6218,45,6173
Closure,4800617,developer,6196,1845,4351
Closure,4800618,developer,6196,22,6174
Closure,4800619,developer,6196,1845,4351
Closure,4800620,developer,6196,22,6174
Closure,4800621,developer,6196,33,6163
Closure,4800622,developer,6196,1845,4351
Closure,4800623,developer,6196,10,6186
Closure,4800624,developer,6196,18,6178
Closure,4800625,developer,6196,18,6178
Closure,4800626,developer,6196,9,6187
Closure,4800627,developer,6196,1,6195
Closure,4800628,developer,6196,9,6187
Closure,4800629,developer,6196,9,6187
Closure,4800630,developer,6196,9,6187
Closure,4900013,developer,1841,30,1811
Closure,4900014,developer,1841,179,1662
Closure,4900033,developer,1841,722,1119
Closure,4900034,developer,1841,1181,660
Closure,4900035,developer,1841,1181,660
Closure,4900036,developer,1841,62,1779
Closure,4900037,developer,1841,634,1207
Closure,4900038,developer,1841,62,1779
Closure,4900039,developer,1841,1181,660
Closure,4900040,developer,1841,53,1788
Closure,4900054,developer,1841,1,1840
Closure,4900056,developer,1841,776,1065
Closure,5000206,developer,101,3,98
Closure,5000207,developer,101,1,100
Closure,5000208,developer,101,1,100
Closure,5000209,developer,101,3,98
Closure,5000217,developer,101,2,99
Closure,5000218,developer,101,1,100
Closure,5000219,developer,101,1,100
Closure,5000220,developer,101,1,100
Closure,5000221,developer,101,2,99
Closure,5000222,developer,101,1,100
Closure,5000223,developer,101,1,100
Closure,5000224,developer,101,2,99
Closure,5000225,developer,101,2,99
Closure,5000226,developer,101,1,100
Closure,5000227,developer,101,1,100
Closure,5000228,developer,101,2,99
Closure,5000229,developer,101,1,100
Closure,5100109,developer,3823,2,3821
Closure,5100110,developer,3823,57,3766
Closure,5100111,developer,3823,57,3766
Closure,5100112,developer,3823,1,3822
Closure,5100113,developer,3823,2,3821
Closure,5200559,developer,3803,5,3798
Closure,5200560,developer,3803,2,3801
Closure,5200561,developer,3803,2,3801
Closure,5200562,developer,3803,6,3797
Closure,5200563,developer,3803,22,3781
Closure,5200564,developer,3803,24,3779
Closure,5200565,developer,3803,6,3797
Closure,5200566,developer,3803,1,3802
Closure,5200567,developer,3803,2,3801
Closure,5200568,developer,3803,6,3797
Closure,5200569,developer,3803,1,3802
Closure,5200570,developer,3803,2,3801
Closure,5300122,developer,116,1,115
Closure,5300123,developer,116,8,108
Closure,5300124,developer,116,1,115
Closure,5400077,developer,6965,2455,4510
Closure,5400078,developer,6965,97,6868
Closure,5400079,developer,6965,11,6954
Closure,5400080,developer,6965,4,6961
Closure,5400081,developer,6965,2459,4506
Closure,5400082,developer,6965,11,6954
Closure,5400083,developer,6965,153,6812
Closure,5400084,developer,6965,6,6959
Closure,5400086,developer,6965,11,6954
Closure,5400092,developer,6965,3,6962
Closure,5400997,developer,6965,3,6962
Closure,5400998,developer,6965,3,6962
Closure,5400999,developer,6965,2,6963
Closure,5401000,developer,6965,3,6962
Closure,5401001,developer,6965,3,6962
Closure,5401002,developer,6965,2,6963
Closure,5401003,developer,6965,4,6961
Closure,5401004,developer,6965,2,6963
Closure,5500021,developer,96,6,90
Closure,5500022,developer,96,1,95
Closure,5500023,developer,96,17,79
Closure,5600037,developer,6086,1,6085
Closure,5600038,developer,6086,3,6083
Closure,5600039,developer,6086,3,6083
Closure,5700073,developer,6063,1,6062
Closure,5700074,developer,6063,1,6062
Closure,5700075,developer,6063,7,6056
Closure,5700076,developer,6063,1,6062
Closure,5700077,developer,6063,7,6056
Closure,5700078,developer,6063,1,6062
Closure,5700079,developer,6063,1,6062
Closure,5800042,developer,177,1,176
Closure,5800044,developer,177,1,176
Closure,5900024,developer,6042,1,6041
Closure,5900025,developer,6042,1,6041
Closure,5900026,developer,6042,22,6020
Closure,6000021,developer,5994,4,5990
Closure,6000034,developer,5994,2,5992
Closure,6000035,developer,5994,5,5989
Closure,6000037,developer,5994,2,5992
Closure,6100373,developer,5987,14,5973
Closure,6100374,developer,5987,19,5968
Closure,6100375,developer,5987,3,5984
Closure,6100376,developer,5987,113,5874
Closure,6100377,developer,5987,3,5984
Closure,6100378,developer,5987,60,5927
Closure,6100379,developer,5987,3,5984
Closure,6200021,developer,6023,4,6019
Closure,6200022,developer,6023,4,6019
Closure,6200023,developer,6023,2,6021
Closure,6200024,developer,6023,2,6021
Closure,6200025,developer,6023,4,6019
Closure,6400256,developer,6004,2,6002
Closure,6400257,developer,6004,2,6002
Closure,6400258,developer,6004,1,6003
Closure,6400259,developer,6004,2,6002
Closure,6400284,developer,6004,2,6002
Closure,6400285,developer,6004,2,6002
Closure,6400286,developer,6004,123,5881
Closure,6400287,developer,6004,1,6003
Closure,6400288,developer,6004,2,6002
Closure,6500715,developer,3732,1,3731
Closure,6500716,developer,3732,1,3731
Closure,6600101,developer,5985,2,5983
Closure,6600102,developer,5985,2,5983
Closure,6700147,developer,134,63,71
Closure,6700148,developer,134,28,106
Closure,6700149,developer,134,6,128
Closure,6700150,developer,134,28,106
Closure,6700151,developer,134,63,71
Closure,6700152,developer,134,28,106
Closure,6700153,developer,134,6,128
Closure,6700154,developer,134,63,71
Closure,6700155,developer,134,1,133
Closure,6700156,developer,134,28,106
Closure,6700157,developer,134,63,71
Closure,6700158,developer,134,28,106
Closure,6700159,developer,134,1,133
Closure,6700160,developer,134,31,103
Closure,6800409,developer,4595,1887,2708
Closure,6800721,developer,4595,1,4594
Closure,6800753,developer,4595,1,4594
Closure,6900581,developer,5985,3,5982
Closure,6900582,developer,5985,460,5525
Closure,6900583,developer,5985,3,5982
Closure,6900584,developer,5985,42,5943
Closure,6900585,developer,5985,3,5982
Closure,6900586,developer,5985,1,5984
Closure,6900587,developer,5985,463,5522
Closure,6900588,developer,5985,3,5982
Closure,6900589,developer,5985,3,5982
Closure,6900590,developer,5985,87,5898
Closure,6900591,developer,5985,87,5898
Closure,6900592,developer,5985,3,5982
Closure,6900593,developer,5985,154,5831
Closure,6900594,developer,5985,3,5982
Closure,6900595,developer,5985,87,5898
Closure,6900596,developer,5985,494,5491
Closure,6900597,developer,5985,3,5982
Closure,7000797,developer,5968,5,5963
Closure,7000798,developer,5968,127,5841
Closure,7100162,developer,5924,1,5923
Closure,7100163,developer,5924,4,5920
Closure,7100164,developer,5924,14,5910
Closure,7100165,developer,5924,4,5920
Closure,7100166,developer,5924,1,5923
Closure,7100167,developer,5924,4,5920
Closure,7100168,developer,5924,4,5920
Closure,7100169,developer,5924,15,5909
Closure,7200034,developer,420,1,419
Closure,7200035,developer,420,1,419
Closure,7200177,developer,420,1,419
Closure,7200178,developer,420,3,417
Closure,7200179,developer,420,2,418
Closure,7300878,developer,3600,1,3599
Closure,7300879,developer,3600,1,3599
Closure,7300880,developer,3600,1,3599
Closure,7300882,developer,3600,85,3515
Closure,7300883,developer,3600,85,3515
Closure,7300884,developer,3600,85,3515
Closure,7300885,developer,3600,3,3597
Closure,7300886,developer,3600,1,3599
Closure,7300887,developer,3600,85,3515
Closure,7300889,developer,3600,85,3515
Closure,7300890,developer,3600,4,3596
Closure,7300891,developer,3600,1,3599
Closure,7400501,developer,170,11,159
Closure,7400502,developer,170,5,165
Closure,7400573,developer,170,11,159
Closure,7400574,developer,170,8,162
Closure,7400575,developer,170,3,167
Closure,7400576,developer,170,3,167
Closure,7400577,developer,170,3,167
Closure,7400578,developer,170,3,167
Closure,7400579,developer,170,12,158
Closure,7500107,developer,5764,1,5763
Closure,7500108,developer,5764,4,5760
Closure,7600123,developer,107,6,101
Closure,7600124,developer,107,9,98
Closure,7600125,developer,107,2,105
Closure,7600126,developer,107,2,105
Closure,7600127,developer,107,2,105
Closure,7600128,developer,107,2,105
Closure,7600129,developer,107,2,105
Closure,7600130,developer,107,1,106
Closure,7600131,developer,107,2,105
Closure,7600132,developer,107,2,105
Closure,7600133,developer,107,1,106
Closure,7600134,developer,107,2,105
Closure,7600137,developer,107,5,102
Closure,7600144,developer,107,15,92
Closure,7600157,developer,107,2,105
Closure,7600158,developer,107,2,105
Closure,7600160,developer,107,14,93
Closure,7700699,developer,3476,1,3475
Closure,7700700,developer,3476,1,3475
Closure,7900014,developer,5675,57,5618
Closure,7900344,developer,5675,4,5671
Closure,8100225,developer,5697,2036,3661
Closure,8100226,developer,5697,1,5696
Closure,8100227,developer,5697,1,5696
Closure,8100228,developer,5697,2036,3661
Closure,8100229,developer,5697,1,5696
Closure,8200013,developer,6358,13,6345
Closure,8200014,developer,6358,22,6336
Closure,8200015,developer,6358,462,5896
Closure,8200016,developer,6358,4,6354
Closure,8200017,developer,6358,29,6329
Closure,8200018,developer,6358,462,5896
Closure,8200019,developer,6358,2,6356
Closure,8200021,developer,6358,2,6356
Closure,8200022,developer,6358,33,6325
Closure,8200023,developer,6358,462,5896
Closure,8300022,developer,53,11,42
Closure,8300023,developer,53,11,42
Closure,8400147,developer,5543,2677,2866
Closure,8400148,developer,5543,2677,2866
Closure,8400149,developer,5543,1,5542
Closure,8400150,developer,5543,1,5542
Closure,8400381,developer,5543,78,5465
Closure,8400382,developer,5543,117,5426
Closure,8400383,developer,5543,78,5465
Closure,8400384,developer,5543,117,5426
Closure,8400385,developer,5543,167,5376
Closure,8400386,developer,5543,186,5357
Closure,8400387,developer,5543,1,5542
Closure,8400388,developer,5543,1,5542
Closure,8400395,developer,5543,2768,2775
Closure,8400396,developer,5543,1,5542
Closure,8500047,developer,77,8,69
Closure,8500053,developer,77,6,71
Closure,8500054,developer,77,6,71
Closure,8500055,developer,77,3,74
Closure,8500056,developer,77,6,71
Closure,8500057,developer,77,3,74
Closure,8500058,developer,77,8,69
Closure,8500059,developer,77,6,71
Closure,8500060,developer,77,5,72
Closure,8600861,developer,5374,7,5367
Closure,8700261,developer,112,12,100
Closure,8700262,developer,112,16,96
Closure,8700263,developer,112,1,111
Closure,8700264,developer,112,15,97
Closure,8700265,developer,112,2,110
Closure,8700266,developer,112,12,100
Closure,8700267,developer,112,1,111
Closure,8700268,developer,112,1,111
Closure,8700269,developer,112,13,99
Closure,8700270,developer,112,1,111
Closure,8700271,developer,112,13,99
Closure,8700272,developer,112,1,111
Closure,8700273,developer,112,2,110
Closure,8700274,developer,112,13,99
Closure,8700275,developer,112,1,111
Closure,8700276,developer,112,16,96
Closure,8700277,developer,112,12,100
Closure,8800139,developer,92,8,84
Closure,8800140,developer,92,8,84
Closure,8800141,developer,92,7,85
Closure,8800142,developer,92,7,85
Closure,8800143,developer,92,7,85
Closure,8900395,developer,443,33,410
Closure,8900396,developer,443,137,306
Closure,8900397,developer,443,137,306
Closure,8900398,developer,443,35,408
Closure,8900678,developer,443,50,393
Closure,8900679,developer,443,1,442
Closure,8900680,developer,443,1,442
Closure,8900681,developer,443,50,393
Closure,8900682,developer,443,1,442
Closure,9000351,developer,6033,2,6031
Closure,9000399,developer,6033,28,6005
Closure,9000400,developer,6033,2,6031
Closure,9100045,developer,96,5,91
Closure,9100046,developer,96,1,95
Closure,9100047,developer,96,1,95
Closure,9100048,developer,96,3,93
Closure,9100049,developer,96,3,93
Closure,9100050,developer,96,1,95
Closure,9100051,developer,96,3,93
Closure,9100052,developer,96,3,93
Closure,9100053,developer,96,1,95
Closure,9100054,developer,96,1,95
Closure,9100055,developer,96,3,93
Closure,9100056,developer,96,1,95
Closure,9200386,developer,1807,6,1801
Closure,9300386,developer,1800,6,1794
Closure,9400077,developer,5157,3,5154
Closure,9400078,developer,5157,2,5155
Closure,9500518,developer,2285,2,2283
Closure,9500520,developer,2285,2,2283
Closure,9500523,developer,2285,54,2231
Closure,9500524,developer,2285,2,2283
Closure,9500527,developer,2285,3,2282
Closure,9500528,developer,2285,1,2284
Closure,9500529,developer,2285,2,2283
Closure,9500530,developer,2285,2,2283
Closure,9600526,developer,5083,16,5067
Closure,9600527,developer,5083,16,5067
Closure,9600528,developer,5083,1,5082
Closure,9600529,developer,5083,16,5067
Closure,9600531,developer,5083,1,5082
Closure,9600532,developer,5083,108,4975
Closure,9600533,developer,5083,16,5067
Closure,9600534,developer,5083,798,4285
Closure,9600535,developer,5083,108,4975
Closure,9600536,developer,5083,16,5067
Closure,9600537,developer,5083,154,4929
Closure,9600538,developer,5083,391,4692
Closure,9600539,developer,5083,8,5075
Closure,9700331,developer,82,1,81
Closure,9700332,developer,82,1,81
Closure,9700333,developer,82,1,81
Closure,9700334,developer,82,1,81
Closure,9700335,developer,82,1,81
Closure,9800110,developer,373,1,372
Closure,9800111,developer,373,116,257
Closure,9800112,developer,373,1,372
Closure,9800113,developer,373,1,372
Closure,9800114,developer,373,1,372
Closure,9800115,developer,373,1,372
Closure,9800116,developer,373,16,357
Closure,9800117,developer,373,1,372
Closure,9800226,developer,373,1,372
Closure,9800227,developer,373,1,372
Closure,9800228,developer,373,1,372
Closure,9800229,developer,373,6,367
Closure,9800230,developer,373,16,357
Closure,9800231,developer,373,6,367
Closure,9800232,developer,373,16,357
Closure,9800233,developer,373,16,357
Closure,9800234,developer,373,6,367
Closure,9800235,developer,373,16,357
Closure,9800236,developer,373,1,372
Closure,9800237,developer,373,1,372
Closure,9800238,developer,373,16,357
Closure,9900007,developer,75,29,46
Closure,9900008,developer,75,1,74
Closure,9900009,developer,75,3,72
Closure,9900010,developer,75,5,70
Closure,9900011,developer,75,4,71
Closure,9900012,developer,75,1,74
Closure,9900013,developer,75,9,66
Closure,9900014,developer,75,29,46
Closure,9900015,developer,75,10,65
Closure,9900016,developer,75,29,46
Closure,9900049,developer,75,7,68
Closure,9900050,developer,75,4,71
Closure,9900055,developer,75,21,54
Closure,9900056,developer,75,12,63
Closure,9900057,developer,75,7,68
Closure,9900058,developer,75,12,63
Closure,9900059,developer,75,7,68
Closure,9900060,developer,75,1,74
Closure,9900061,developer,75,12,63
Closure,10000014,developer,71,7,64
Closure,10000015,developer,71,5,66
Closure,10000016,developer,71,1,70
Closure,10000017,developer,71,5,66
Closure,10000018,developer,71,4,67
Closure,10000019,developer,71,4,67
Closure,10000020,developer,71,1,70
Closure,10000021,developer,71,5,66
Closure,10000022,developer,71,5,66
Closure,10000023,developer,71,3,68
Closure,10000024,developer,71,3,68
Closure,10000025,developer,71,4,67
Closure,10000026,developer,71,5,66
Closure,10000027,developer,71,5,66
Closure,10000028,developer,71,2,69
Closure,10000029,developer,71,2,69
Closure,10000030,developer,71,6,65
Closure,10000031,developer,71,5,66
Closure,10000032,developer,71,5,66
Closure,10000068,developer,71,5,66
Closure,10000069,developer,71,4,67
Closure,10100057,developer,21,1,20
Closure,10200007,developer,778,5,773
Closure,10200012,developer,778,5,773
Closure,10300581,developer,1488,1,1487
Closure,10300582,developer,1488,1,1487
Closure,10300583,developer,1488,1,1487
Closure,10300584,developer,1488,1,1487
Closure,10300585,developer,1488,1,1487
Closure,10300586,developer,1488,1,1487
Closure,10300587,developer,1488,1,1487
Closure,10300588,developer,1488,1,1487
Closure,10400053,developer,4350,1,4349
Closure,10400054,developer,4350,7,4343
Closure,10500983,developer,106,2,104
Closure,10500984,developer,106,2,104
Closure,10500987,developer,106,2,104
Closure,10500990,developer,106,1,105
Closure,10500993,developer,106,2,104
Closure,10600374,developer,1209,142,1067
Closure,10600375,developer,1209,4,1205
Closure,10600456,developer,1209,1,1208
Closure,10600457,developer,1209,1,1208
Closure,10700117,developer,115,1,114
Closure,10800062,developer,452,63,389
Closure,10800157,developer,452,1,451
Closure,10800252,developer,452,63,389
Closure,10800253,developer,452,6,446
Closure,10800254,developer,452,18,434
Closure,10800255,developer,452,1,451
Closure,10800256,developer,452,63,389
Closure,10900902,developer,6099,1,6098
Closure,10900903,developer,6099,1,6098
Closure,10900904,developer,6099,38,6061
Closure,11001066,developer,8112,2,8110
Closure,11001080,developer,8112,2,8110
Closure,11001081,developer,8112,6,8106
Closure,11001082,developer,8112,1,8111
Closure,11001083,developer,8112,1,8111
Closure,11001093,developer,8112,2,8110
Closure,11001094,developer,8112,6,8106
Closure,11001095,developer,8112,2,8110
Closure,11001096,developer,8112,2,8110
Closure,11001097,developer,8112,2,8110
Closure,11001098,developer,8112,2,8110
Closure,11001099,developer,8112,3,8109
Closure,11001100,developer,8112,4,8108
Closure,11001101,developer,8112,5,8107
Closure,11001108,developer,8112,1,8111
Closure,11001109,developer,8112,1,8111
Closure,11001110,developer,8112,1,8111
Closure,11100001,developer,2498,2,2496
Closure,11200599,developer,3222,31,3191
Closure,11300129,developer,2642,1,2641
Closure,11300130,developer,2642,17,2625
Closure,11300131,developer,2642,1,2641
Closure,11300132,developer,2642,1,2641
Closure,11400097,developer,638,1,637
Closure,11400098,developer,638,6,632
Closure,11400099,developer,638,1,637
Closure,11400100,developer,638,58,580
Closure,11600211,developer,696,8,688
Closure,11600212,developer,696,22,674
Closure,11600213,developer,696,135,561
Closure,11600214,developer,696,8,688
Closure,11600215,developer,696,8,688
Closure,11600234,developer,696,27,669
Closure,11600235,developer,696,8,688
Closure,11600236,developer,696,3,693
Closure,11600237,developer,696,15,681
Closure,11600238,developer,696,11,685
Closure,11700211,developer,7149,352,6797
Closure,11700212,developer,7149,12,7137
Closure,11700214,developer,7149,12,7137
Closure,11700215,developer,7149,1,7148
Closure,11700216,developer,7149,12,7137
Closure,11700217,developer,7149,3,7146
Closure,11700218,developer,7149,213,6936
Closure,11700219,developer,7149,3,7146
Closure,11700220,developer,7149,39,7110
Closure,11700221,developer,7149,213,6936
Closure,11700222,developer,7149,3,7146
Closure,11700224,developer,7149,39,7110
Closure,11700225,developer,7149,2,7147
Closure,11700226,developer,7149,215,6934
Closure,11700227,developer,7149,57,7092
Closure,11700254,developer,7149,190,6959
Closure,11800129,developer,7142,2,7140
Closure,11800130,developer,7142,5,7137
Closure,11800131,developer,7142,2,7140
Closure,12000125,developer,7134,18,7116
Closure,12000126,developer,7134,1,7133
Closure,12100136,developer,461,3,458
Closure,12100137,developer,461,12,449
Closure,12100138,developer,461,67,394
Closure,12100139,developer,461,8,453
Closure,12100140,developer,461,59,402
Closure,12100141,developer,461,12,449
Closure,12100142,developer,461,75,386
Closure,12100143,developer,461,77,384
Closure,12100144,developer,461,12,449
Closure,12100145,developer,461,23,438
Closure,12100146,developer,461,75,386
Closure,12100147,developer,461,12,449
Closure,12100148,developer,461,1,460
Closure,12100149,developer,461,98,363
Closure,12100150,developer,461,12,449
Closure,12100151,developer,461,1,460
Closure,12100152,developer,461,103,358
Closure,12200049,developer,7167,6,7161
Closure,12200050,developer,7167,28,7139
Closure,12300193,developer,4492,1,4491
Closure,12500644,developer,7061,7,7054
Closure,12500645,developer,7061,7,7054
Closure,12500646,developer,7061,10,7051
Closure,12500647,developer,7061,1,7060
Closure,12500648,developer,7061,7,7054
Closure,12700049,developer,336,8,328
Closure,12700050,developer,336,3,333
Closure,12700051,developer,336,8,328
Closure,12700052,developer,336,6,330
Closure,12700053,developer,336,7,329
Closure,12700055,developer,336,3,333
Closure,12700056,developer,336,3,333
Closure,12700057,developer,336,3,333
Closure,12700058,developer,336,6,330
Closure,12700059,developer,336,8,328
Closure,12700060,developer,336,6,330
Closure,12700061,developer,336,8,328
Closure,12700062,developer,336,6,330
Closure,12700063,developer,336,6,330
Closure,12800634,developer,4283,8,4275
Closure,12800635,developer,4283,2,4281
Closure,12800636,developer,4283,7,4276
Closure,12800637,developer,4283,2,4281
Closure,12800645,developer,4283,1,4282
Closure,12800646,developer,4283,1,4282
Closure,12800647,developer,4283,1,4282
Closure,12800648,developer,4283,1,4282
Closure,12800649,developer,4283,2,4281
Closure,12800650,developer,4283,4,4279
Closure,12800651,developer,4283,2,4281
Closure,12800652,developer,4283,1,4282
Closure,12800653,developer,4283,5,4278
Closure,12800654,developer,4283,2,4281
Closure,12800655,developer,4283,1,4282
Closure,12800656,developer,4283,1,4282
Closure,13000018,developer,577,11,566
Closure,13000019,developer,577,11,566
Closure,13000020,developer,577,1,576
Closure,13000021,developer,577,11,566
Closure,13000022,developer,577,11,566
Closure,13000023,developer,577,1,576
Closure,13000024,developer,577,1,576
Closure,13000025,developer,577,13,564
Closure,13000026,developer,577,11,566
Closure,13000027,developer,577,2,575
Closure,13000028,developer,577,11,566
Closure,13000029,developer,577,1,576
Closure,13000030,developer,577,11,566
Closure,13000031,developer,577,2,575
Closure,13000032,developer,577,2,575
Closure,13000033,developer,577,11,566
Closure,13000034,developer,577,11,566
Closure,13000035,developer,577,11,566
Closure,13000036,developer,577,5,572
Closure,13100059,developer,2987,165,2822
Closure,13100060,developer,2987,3,2984
Closure,13100062,developer,2987,3,2984
Closure,13100063,developer,2987,349,2638
Closure,13100064,developer,2987,612,2375
Closure,13100065,developer,2987,3,2984
Closure,13100066,developer,2987,3,2984
Closure,13100068,developer,2987,349,2638
Closure,13100069,developer,2987,612,2375
Closure,13100070,developer,2987,3,2984
Closure,13100071,developer,2987,7,2980
Closure,13100072,developer,2987,3,2984
Closure,13100078,developer,2987,3,2984
Closure,13100079,developer,2987,2,2985
Closure,13200410,developer,396,4,392
Closure,13200411,developer,396,1,395
Closure,13200412,developer,396,1,395
Closure,13200413,developer,396,1,395
Closure,13200414,developer,396,3,393
Closure,13200415,developer,396,1,395
Closure,13200416,developer,396,1,395
Closure,13200417,developer,396,1,395
Closure,13200418,developer,396,4,392
Closure,13200419,developer,396,1,395
Closure,13301153,developer,5493,1,5492
Lang,1,developer,88,1,87
Lang,2,developer,14,1,13
Lang,3,developer,87,1,86
Lang,4,developer,31,1,30
Lang,5,developer,13,1,12
Lang,6,developer,130,1,129
Lang,7,developer,82,1,81
Lang,8,developer,103,2,101
Lang,9,developer,115,2,113
Lang,10,developer,113,2,111
Lang,11,developer,6,1,5
Lang,12,developer,5,2,3
Lang,13,developer,35,1,34
Lang,14,developer,313,1,312
Lang,15,developer,10,2,8
Lang,16,developer,82,1,81
Lang,17,developer,36,1,35
Lang,18,developer,48,1,47
Lang,19,developer,23,2,21
Lang,20,developer,235,2,233
Lang,21,developer,109,1,108
Lang,22,developer,25,2,23
Lang,23,developer,8,1,7
Lang,24,developer,57,1,56
Lang,25,developer,23,1,22
Lang,26,developer,47,1,46
Lang,27,developer,57,1,56
Lang,28,developer,20,1,19
Lang,29,developer,423,1,422
Lang,30,developer,413,10,403
Lang,31,developer,402,2,400
Lang,32,developer,45,1,44
Lang,33,developer,113,1,112
Lang,34,developer,152,27,125
Lang,35,developer,331,1,330
Lang,36,developer,65,2,63
Lang,37,developer,314,1,313
Lang,38,developer,45,1,44
Lang,39,developer,198,1,197
Lang,40,developer,196,1,195
Lang,41,developer,78,2,76
Lang,42,developer,54,1,53
Lang,43,developer,7,1,6
Lang,44,developer,20,1,19
Lang,45,developer,81,1,80
Lang,46,developer,19,1,18
Lang,47,developer,206,2,204
Lang,48,developer,63,1,62
Lang,49,developer,25,1,24
Lang,50,developer,21,2,19
Lang,51,developer,52,1,51
Lang,52,developer,14,1,13
Lang,53,developer,22,1,21
Lang,54,developer,12,1,11
Lang,55,developer,6,1,5
Lang,56,developer,19,1,18
Lang,57,developer,11,11,0
Lang,58,developer,74,1,73
Lang,59,developer,182,1,181
Lang,60,developer,185,1,184
Lang,61,developer,184,2,182
Lang,62,developer,42,1,41
Lang,63,developer,12,1,11
Lang,64,developer,73,1,72
Lang,65,developer,21,1,20
Lang,100061,developer,88,1,87
Lang,100062,developer,88,1,87
Lang,100063,developer,88,1,87
Lang,100064,developer,88,2,86
Lang,100065,developer,88,1,87
Lang,100066,developer,88,1,87
Lang,100067,developer,88,2,86
Lang,100072,developer,88,3,85
Lang,100073,developer,88,3,85
Lang,100074,developer,88,3,85
Lang,100075,developer,88,2,86
Lang,100076,developer,88,1,87
Lang,100077,developer,88,1,87
Lang,100078,developer,88,1,87
Lang,100079,developer,88,2,86
Lang,100080,developer,88,1,87
Lang,100081,developer,88,2,86
Lang,100082,developer,88,1,87
Lang,100083,developer,88,2,86
Lang,100084,developer,88,1,87
Lang,100085,developer,88,2,86
Lang,100086,developer,88,2,86
Lang,100087,developer,88,1,87
Lang,100088,developer,88,1,87
Lang,100089,developer,88,3,85
Lang,100091,developer,88,2,86
Lang,100092,developer,88,2,86
Lang,100093,developer,88,1,87
Lang,100094,developer,88,2,86
Lang,100095,developer,88,2,86
Lang,100096,developer,88,1,87
Lang,100097,developer,88,1,87
Lang,100098,developer,88,1,87
Lang,100099,developer,88,1,87
Lang,100100,developer,88,1,87
Lang,100101,developer,88,1,87
Lang,100102,developer,88,1,87
Lang,100103,developer,88,1,87
Lang,100104,developer,88,2,86
Lang,100105,developer,88,1,87
Lang,100106,developer,88,1,87
Lang,100107,developer,88,2,86
Lang,100108,developer,88,2,86
Lang,200004,developer,14,1,13
Lang,200005,developer,14,6,8
Lang,300199,developer,87,3,84
Lang,300200,developer,87,3,84
Lang,300201,developer,87,1,86
Lang,300202,developer,87,2,85
Lang,300203,developer,87,1,86
Lang,300216,developer,87,3,84
Lang,300217,developer,87,3,84
Lang,300218,developer,87,2,85
Lang,300219,developer,87,3,84
Lang,300220,developer,87,1,86
Lang,400001,developer,31,31,0
Lang,400002,developer,31,14,17
Lang,400003,developer,31,31,0
Lang,400004,developer,31,14,17
Lang,400005,developer,31,31,0
Lang,400006,developer,31,14,17
Lang,400034,developer,31,14,17
Lang,500012,developer,13,4,9
Lang,500013,developer,13,1,12
Lang,500014,developer,13,1,12
Lang,500015,developer,13,1,12
Lang,500016,developer,13,1,12
Lang,500017,developer,13,1,12
Lang,500018,developer,13,1,12
Lang,500019,developer,13,1,12
Lang,500020,developer,13,1,12
Lang,500021,developer,13,1,12
Lang,500022,developer,13,1,12
Lang,500023,developer,13,1,12
Lang,500024,developer,13,1,12
Lang,500025,developer,13,1,12
Lang,500026,developer,13,1,12
Lang,500027,developer,13,1,12
Lang,500028,developer,13,1,12
Lang,500029,developer,13,1,12
Lang,500030,developer,13,1,12
Lang,500031,developer,13,1,12
Lang,500032,developer,13,1,12
Lang,500033,developer,13,1,12
Lang,500034,developer,13,1,12
Lang,500035,developer,13,1,12
Lang,500036,developer,13,1,12
Lang,500037,developer,13,1,12
Lang,500038,developer,13,1,12
Lang,500039,developer,13,1,12
Lang,500040,developer,13,1,12
Lang,500041,developer,13,1,12
Lang,500042,developer,13,1,12
Lang,500043,developer,13,1,12
Lang,500044,developer,13,1,12
Lang,500045,developer,13,1,12
Lang,500046,developer,13,1,12
Lang,500047,developer,13,1,12
Lang,500048,developer,13,1,12
Lang,600026,developer,130,31,99
Lang,700052,developer,82,1,81
Lang,700053,developer,82,1,81
Lang,700054,developer,82,3,79
Lang,700055,developer,82,1,81
Lang,700056,developer,82,1,81
Lang,700057,developer,82,3,79
Lang,700058,developer,82,1,81
Lang,700059,developer,82,1,81
Lang,700060,developer,82,3,79
Lang,700210,developer,82,2,80
Lang,800447,developer,103,4,99
Lang,900026,developer,115,2,113
Lang,1000060,developer,113,37,76
Lang,1100042,developer,6,1,5
Lang,1100043,developer,6,1,5
Lang,1200023,developer,5,2,3
Lang,1200024,developer,5,1,4
Lang,1200025,developer,5,2,3
Lang,1200026,developer,5,2,3
Lang,1200027,developer,5,2,3
Lang,1200028,developer,5,2,3
Lang,1200037,developer,5,2,3
Lang,1200038,developer,5,1,4
Lang,1300021,developer,35,6,29
Lang,1300023,developer,35,1,34
Lang,1300024,developer,35,1,34
Lang,1300025,developer,35,1,34
Lang,1300026,developer,35,1,34
Lang,1300027,developer,35,1,34
Lang,1300028,developer,35,1,34
Lang,1300029,developer,35,1,34
Lang,1300030,developer,35,1,34
Lang,1300031,developer,35,1,34
Lang,1300033,developer,35,1,34
Lang,1300034,developer,35,1,34
Lang,1400146,developer,313,1,312
Lang,1400147,developer,313,1,312
Lang,1400149,developer,313,1,312
Lang,1400150,developer,313,1,312
Lang,1400151,developer,313,1,312
Lang,1400152,developer,313,1,312
Lang,1500030,developer,10,3,7
Lang,1500031,developer,10,2,8
Lang,1500111,developer,10,1,9
Lang,1500112,developer,10,4,6
Lang,1600053,developer,82,1,81
Lang,1600054,developer,82,1,81
Lang,1600055,developer,82,3,79
Lang,1600056,developer,82,1,81
Lang,1600057,developer,82,1,81
Lang,1600058,developer,82,3,79
Lang,1600059,developer,82,1,81
Lang,1600060,developer,82,1,81
Lang,1600061,developer,82,3,79
Lang,1700011,developer,36,33,3
Lang,1700021,developer,36,24,12
Lang,1700025,developer,36,27,9
Lang,1800053,developer,48,2,46
Lang,1800054,developer,48,2,46
Lang,1800055,developer,48,1,47
Lang,1800056,developer,48,14,34
Lang,1800057,developer,48,2,46
Lang,1800058,developer,48,3,45
Lang,1800059,developer,48,1,47
Lang,1800060,developer,48,1,47
Lang,1900002,developer,23,4,19
Lang,1900003,developer,23,1,22
Lang,1900004,developer,23,1,22
Lang,1900005,developer,23,4,19
Lang,1900006,developer,23,1,22
Lang,1900007,developer,23,1,22
Lang,1900008,developer,23,1,22
Lang,1900009,developer,23,1,22
Lang,1900010,developer,23,1,22
Lang,1900011,developer,23,4,19
Lang,1900012,developer,23,6,17
Lang,1900013,developer,23,4,19
Lang,1900014,developer,23,1,22
Lang,1900015,developer,23,4,19
Lang,1900016,developer,23,6,17
Lang,1900017,developer,23,4,19
Lang,1900018,developer,23,4,19
Lang,1900019,developer,23,6,17
Lang,1900020,developer,23,4,19
Lang,1900021,developer,23,4,19
Lang,1900022,developer,23,7,16
Lang,1900023,developer,23,4,19
Lang,1900024,developer,23,6,17
Lang,1900043,developer,23,2,21
Lang,1900044,developer,23,1,22
Lang,1900047,developer,23,4,19
Lang,1900048,developer,23,4,19
Lang,1900049,developer,23,3,20
Lang,1900050,developer,23,1,22
Lang,1900051,developer,23,1,22
Lang,1900052,developer,23,4,19
Lang,1900053,developer,23,3,20
Lang,1900054,developer,23,4,19
Lang,1900055,developer,23,3,20
Lang,1900056,developer,23,1,22
Lang,1900057,developer,23,1,22
Lang,1900058,developer,23,1,22
Lang,1900059,developer,23,4,19
Lang,1900060,developer,23,1,22
Lang,1900061,developer,23,1,22
Lang,1900062,developer,23,1,22
Lang,1900063,developer,23,4,19
Lang,1900064,developer,23,1,22
Lang,1900065,developer,23,4,19
Lang,1900066,developer,23,4,19
Lang,1900067,developer,23,1,22
Lang,1900068,developer,23,4,19
Lang,1900069,developer,23,1,22
Lang,1900070,developer,23,1,22
Lang,1900071,developer,23,4,19
Lang,1900072,developer,23,1,22
Lang,1900073,developer,23,4,19
Lang,1900074,developer,23,4,19
Lang,1900076,developer,23,4,19
Lang,1900099,developer,23,3,20
Lang,1900100,developer,23,1,22
Lang,1900101,developer,23,3,20
Lang,1900102,developer,23,3,20
Lang,1900103,developer,23,1,22
Lang,1900104,developer,23,4,19
Lang,1900105,developer,23,4,19
Lang,1900106,developer,23,3,20
Lang,1900107,developer,23,2,21
Lang,1900108,developer,23,2,21
Lang,1900109,developer,23,4,19
Lang,1900110,developer,23,4,19
Lang,1900111,developer,23,1,22
Lang,1900112,developer,23,4,19
Lang,1900113,developer,23,4,19
Lang,1900114,developer,23,2,21
Lang,1900115,developer,23,2,21
Lang,1900116,developer,23,2,21
Lang,1900117,developer,23,4,19
Lang,1900118,developer,23,4,19
Lang,1900119,developer,23,2,21
Lang,1900120,developer,23,4,19
Lang,1900121,developer,23,3,20
Lang,1900122,developer,23,3,20
Lang,1900123,developer,23,1,22
Lang,1900124,developer,23,1,22
Lang,1900125,developer,23,4,19
Lang,1900126,developer,23,4,19
Lang,1900127,developer,23,3,20
Lang,1900128,developer,23,4,19
Lang,2001164,developer,235,2,233
Lang,2001165,developer,235,2,233
Lang,2001186,developer,235,4,231
Lang,2001187,developer,235,4,231
Lang,2100029,developer,109,1,108
Lang,2100030,developer,109,1,108
Lang,2100031,developer,109,1,108
Lang,2100032,developer,109,1,108
Lang,2100033,developer,109,1,108
Lang,2100034,developer,109,1,108
Lang,2100035,developer,109,1,108
Lang,2100036,developer,109,1,108
Lang,2100037,developer,109,1,108
Lang,2100038,developer,109,1,108
Lang,2100039,developer,109,1,108
Lang,2100040,developer,109,1,108
Lang,2100041,developer,109,1,108
Lang,2100042,developer,109,1,108
Lang,2100043,developer,109,1,108
Lang,2100044,developer,109,1,108
Lang,2100045,developer,109,1,108
Lang,2100046,developer,109,1,108
Lang,2100047,developer,109,1,108
Lang,2100048,developer,109,1,108
Lang,2100049,developer,109,1,108
Lang,2100050,developer,109,1,108
Lang,2200420,developer,25,8,17
Lang,2200421,developer,25,1,24
Lang,2200422,developer,25,6,19
Lang,2200423,developer,25,9,16
Lang,2200424,developer,25,8,17
Lang,2200425,developer,25,10,15
Lang,2200426,developer,25,10,15
Lang,2200427,developer,25,2,23
Lang,2200428,developer,25,8,17
Lang,2200429,developer,25,8,17
Lang,2200430,developer,25,8,17
Lang,2300046,developer,8,1,7
Lang,2300047,developer,8,1,7
Lang,2300048,developer,8,1,7
Lang,2300049,developer,8,1,7
Lang,2300050,developer,8,1,7
Lang,2300051,developer,8,1,7
Lang,2300052,developer,8,1,7
Lang,2300053,developer,8,1,7
Lang,2300054,developer,8,1,7
Lang,2300055,developer,8,1,7
Lang,2300056,developer,8,1,7
Lang,2300057,developer,8,1,7
Lang,2300058,developer,8,1,7
Lang,2300059,developer,8,1,7
Lang,2400611,developer,57,1,56
Lang,2400612,developer,57,1,56
Lang,2400613,developer,57,1,56
Lang,2400614,developer,57,1,56
Lang,2400615,developer,57,1,56
Lang,2600233,developer,47,31,16
Lang,2700076,developer,57,2,55
Lang,2700077,developer,57,1,56
Lang,2700078,developer,57,2,55
Lang,2700079,developer,57,1,56
Lang,2700080,developer,57,2,55
Lang,2700086,developer,57,1,56
Lang,2700087,developer,57,1,56
Lang,2800046,developer,20,2,18
Lang,2800047,developer,20,2,18
Lang,2800048,developer,20,2,18
Lang,2800049,developer,20,1,19
Lang,2800050,developer,20,1,19
Lang,2800051,developer,20,1,19
Lang,2800052,developer,20,1,19
Lang,2800053,developer,20,1,19
Lang,2800054,developer,20,1,19
Lang,2800055,developer,20,1,19
Lang,2800056,developer,20,1,19
Lang,2800057,developer,20,1,19
Lang,3000345,developer,413,2,411
Lang,3000347,developer,413,2,411
Lang,3000358,developer,413,2,411
Lang,3000359,developer,413,2,411
Lang,3000360,developer,413,2,411
Lang,3000361,developer,413,2,411
Lang,3000362,developer,413,2,411
Lang,3000363,developer,413,2,411
Lang,3000364,developer,413,2,411
Lang,3000365,developer,413,2,411
Lang,3000366,developer,413,2,411
Lang,3000367,developer,413,2,411
Lang,3000368,developer,413,2,411
Lang,3000369,developer,413,2,411
Lang,3000370,developer,413,2,411
Lang,3000371,developer,413,2,411
Lang,3000372,developer,413,2,411
Lang,3000373,developer,413,2,411
Lang,3000374,developer,413,2,411
Lang,3000375,developer,413,2,411
Lang,3000376,developer,413,2,411
Lang,3000377,developer,413,2,411
Lang,3000413,developer,413,4,409
Lang,3000414,developer,413,2,411
Lang,3000415,developer,413,4,409
Lang,3000416,developer,413,2,411
Lang,3000417,developer,413,2,411
Lang,3000418,developer,413,2,411
Lang,3000419,developer,413,2,411
Lang,3000420,developer,413,2,411
Lang,3000421,developer,413,2,411
Lang,3000422,developer,413,2,411
Lang,3000423,developer,413,2,411
Lang,3000424,developer,413,2,411
Lang,3000425,developer,413,2,411
Lang,3000426,developer,413,2,411
Lang,3000427,developer,413,2,411
Lang,3000440,developer,413,1,412
Lang,3000442,developer,413,1,412
Lang,3000453,developer,413,1,412
Lang,3000454,developer,413,1,412
Lang,3000455,developer,413,1,412
Lang,3000456,developer,413,7,406
Lang,3000457,developer,413,1,412
Lang,3000458,developer,413,1,412
Lang,3000459,developer,413,1,412
Lang,3000460,developer,413,1,412
Lang,3000461,developer,413,1,412
Lang,3000462,developer,413,1,412
Lang,3000463,developer,413,1,412
Lang,3000464,developer,413,1,412
Lang,3000465,developer,413,1,412
Lang,3000466,developer,413,1,412
Lang,3000467,developer,413,1,412
Lang,3000468,developer,413,1,412
Lang,3000469,developer,413,1,412
Lang,3000470,developer,413,1,412
Lang,3000471,developer,413,1,412
Lang,3000472,developer,413,1,412
Lang,3000473,developer,413,1,412
Lang,3000474,developer,413,1,412
Lang,3000488,developer,413,2,411
Lang,3000489,developer,413,1,412
Lang,3000490,developer,413,2,411
Lang,3000491,developer,413,2,411
Lang,3000492,developer,413,1,412
Lang,3000493,developer,413,1,412
Lang,3000494,developer,413,1,412
Lang,3000495,developer,413,1,412
Lang,3000496,developer,413,1,412
Lang,3000497,developer,413,1,412
Lang,3000498,developer,413,1,412
Lang,3000499,developer,413,1,412
Lang,3000500,developer,413,1,412
Lang,3000501,developer,413,1,412
Lang,3000502,developer,413,1,412
Lang,3000503,developer,413,1,412
Lang,3000504,developer,413,1,412
Lang,3000505,developer,413,1,412
Lang,3000506,developer,413,1,412
Lang,3000507,developer,413,1,412
Lang,3000509,developer,413,2,411
Lang,3000510,developer,413,1,412
Lang,3000511,developer,413,1,412
Lang,3000546,developer,413,2,411
Lang,3000547,developer,413,2,411
Lang,3000548,developer,413,2,411
Lang,3000549,developer,413,2,411
Lang,3000550,developer,413,2,411
Lang,3000552,developer,413,2,411
Lang,3000553,developer,413,2,411
Lang,3000554,developer,413,4,409
Lang,3000555,developer,413,2,411
Lang,3000556,developer,413,2,411
Lang,3000557,developer,413,2,411
Lang,3000568,developer,413,4,409
Lang,3000569,developer,413,2,411
Lang,3000570,developer,413,4,409
Lang,3000571,developer,413,2,411
Lang,3000572,developer,413,2,411
Lang,3000573,developer,413,2,411
Lang,3000574,developer,413,2,411
Lang,3000575,developer,413,2,411
Lang,3000576,developer,413,2,411
Lang,3000577,developer,413,2,411
Lang,3000578,developer,413,2,411
Lang,3000579,developer,413,2,411
Lang,3000580,developer,413,2,411
Lang,3000581,developer,413,2,411
Lang,3000582,developer,413,2,411
Lang,3000583,developer,413,2,411
Lang,3100368,developer,402,2,400
Lang,3100369,developer,402,2,400
Lang,3100379,developer,402,2,400
Lang,3100380,developer,402,2,400
Lang,3100381,developer,402,2,400
Lang,3100382,developer,402,2,400
Lang,3100383,developer,402,2,400
Lang,3100384,developer,402,2,400
Lang,3100385,developer,402,2,400
Lang,3100386,developer,402,2,400
Lang,3100387,developer,402,2,400
Lang,3100388,developer,402,2,400
Lang,3100389,developer,402,2,400
Lang,3100390,developer,402,2,400
Lang,3100391,developer,402,2,400
Lang,3100392,developer,402,2,400
Lang,3100393,developer,402,2,400
Lang,3100394,developer,402,2,400
Lang,3100395,developer,402,2,400
Lang,3100396,developer,402,2,400
Lang,3200001,developer,45,8,37
Lang,3200003,developer,45,1,44
Lang,3200004,developer,45,8,37
Lang,3200005,developer,45,8,37
Lang,3200006,developer,45,1,44
Lang,3200007,developer,45,8,37
Lang,3200056,developer,45,8,37
Lang,3200057,developer,45,8,37
Lang,3200059,developer,45,3,42
Lang,3200060,developer,45,3,42
Lang,3200061,developer,45,1,44
Lang,3200062,developer,45,1,44
Lang,3300331,developer,113,1,112
Lang,3300332,developer,113,1,112
Lang,3400007,developer,152,9,143
Lang,3400009,developer,152,21,131
Lang,3400010,developer,152,21,131
Lang,3400011,developer,152,9,143
Lang,3400012,developer,152,83,69
Lang,3400013,developer,152,21,131
Lang,3600084,developer,65,3,62
Lang,3600085,developer,65,1,64
Lang,3600086,developer,65,3,62
Lang,3600087,developer,65,1,64
Lang,3600088,developer,65,2,63
Lang,3600573,developer,65,1,64
Lang,3600574,developer,65,1,64
Lang,3600575,developer,65,1,64
Lang,3600576,developer,65,1,64
Lang,3600577,developer,65,1,64
Lang,3701757,developer,314,1,313
Lang,3701758,developer,314,1,313
Lang,3800238,developer,45,1,44
Lang,3901264,developer,198,1,197
Lang,3901265,developer,198,1,197
Lang,3901266,developer,198,1,197
Lang,4000260,developer,196,2,194
Lang,4000261,developer,196,1,195
Lang,4000262,developer,196,1,195
Lang,4000263,developer,196,2,194
Lang,4000264,developer,196,2,194
Lang,4000265,developer,196,1,195
Lang,4000266,developer,196,2,194
Lang,4000267,developer,196,2,194
Lang,4000268,developer,196,2,194
Lang,4000269,developer,196,2,194
Lang,4000270,developer,196,2,194
Lang,4000271,developer,196,2,194
Lang,4100037,developer,78,30,48
Lang,4100038,developer,78,1,77
Lang,4100039,developer,78,1,77
Lang,4100040,developer,78,1,77
Lang,4100041,developer,78,1,77
Lang,4100042,developer,78,1,77
Lang,4100043,developer,78,1,77
Lang,4100044,developer,78,1,77
Lang,4100045,developer,78,1,77
Lang,4100046,developer,78,1,77
Lang,4100047,developer,78,1,77
Lang,4100048,developer,78,1,77
Lang,4100049,developer,78,1,77
Lang,4100050,developer,78,1,77
Lang,4100051,developer,78,1,77
Lang,4100052,developer,78,1,77
Lang,4100053,developer,78,1,77
Lang,4100054,developer,78,1,77
Lang,4100055,developer,78,1,77
Lang,4100056,developer,78,1,77
Lang,4100057,developer,78,1,77
Lang,4100058,developer,78,1,77
Lang,4100059,developer,78,1,77
Lang,4100060,developer,78,1,77
Lang,4100061,developer,78,1,77
Lang,4100062,developer,78,1,77
Lang,4100063,developer,78,1,77
Lang,4100064,developer,78,1,77
Lang,4100065,developer,78,1,77
Lang,4100066,developer,78,1,77
Lang,4100067,developer,78,1,77
Lang,4100068,developer,78,30,48
Lang,4100069,developer,78,1,77
Lang,4100079,developer,78,30,48
Lang,4100086,developer,78,1,77
Lang,4100087,developer,78,1,77
Lang,4100088,developer,78,1,77
Lang,4100089,developer,78,6,72
Lang,4100090,developer,78,1,77
Lang,4100091,developer,78,1,77
Lang,4100092,developer,78,1,77
Lang,4100093,developer,78,1,77
Lang,4100094,developer,78,6,72
Lang,4100096,developer,78,1,77
Lang,4100097,developer,78,6,72
Lang,4100098,developer,78,1,77
Lang,4100099,developer,78,6,72
Lang,4100100,developer,78,1,77
Lang,4100102,developer,78,1,77
Lang,4100104,developer,78,1,77
Lang,4100105,developer,78,6,72
Lang,4100106,developer,78,1,77
Lang,4100107,developer,78,1,77
Lang,4100108,developer,78,1,77
Lang,4100109,developer,78,1,77
Lang,4100110,developer,78,1,77
Lang,4100111,developer,78,1,77
Lang,4100112,developer,78,1,77
Lang,4100113,developer,78,1,77
Lang,4100114,developer,78,6,72
Lang,4100115,developer,78,1,77
Lang,4100116,developer,78,1,77
Lang,4100117,developer,78,1,77
Lang,4100118,developer,78,1,77
Lang,4200192,developer,54,6,48
Lang,4200195,developer,54,3,51
Lang,4200196,developer,54,3,51
Lang,4200197,developer,54,1,53
Lang,4200198,developer,54,3,51
Lang,4200199,developer,54,1,53
Lang,4200200,developer,54,1,53
Lang,4200201,developer,54,3,51
Lang,4200202,developer,54,1,53
Lang,4200203,developer,54,3,51
Lang,4200204,developer,54,1,53
Lang,4200205,developer,54,1,53
Lang,4200206,developer,54,1,53
Lang,4200207,developer,54,1,53
Lang,4200208,developer,54,3,51
Lang,4200209,developer,54,3,51
Lang,4200210,developer,54,3,51
Lang,4200211,developer,54,1,53
Lang,4200212,developer,54,2,52
Lang,4300130,developer,7,1,6
Lang,4400009,developer,20,1,19
Lang,4400010,developer,20,1,19
Lang,4400011,developer,20,2,18
Lang,4400012,developer,20,1,19
Lang,4400013,developer,20,2,18
Lang,4400014,developer,20,2,18
Lang,4400015,developer,20,2,18
Lang,4400016,developer,20,1,19
Lang,4400017,developer,20,1,19
Lang,4400018,developer,20,2,18
Lang,4500237,developer,81,1,80
Lang,4500238,developer,81,1,80
Lang,4500239,developer,81,1,80
Lang,4600003,developer,19,1,18
Lang,4600004,developer,19,1,18
Lang,4600005,developer,19,1,18
Lang,4600006,developer,19,1,18
Lang,4600007,developer,19,1,18
Lang,4600008,developer,19,1,18
Lang,4600009,developer,19,1,18
Lang,4600065,developer,19,1,18
Lang,4600066,developer,19,1,18
Lang,4700451,developer,206,1,205
Lang,4700452,developer,206,1,205
Lang,4700485,developer,206,1,205
Lang,4700486,developer,206,1,205
Lang,4800072,developer,63,1,62
Lang,4800073,developer,63,1,62
Lang,4800074,developer,63,1,62
Lang,4900339,developer,25,1,24
Lang,4900340,developer,25,1,24
Lang,4900341,developer,25,1,24
Lang,4900342,developer,25,1,24
Lang,4900343,developer,25,1,24
Lang,4900344,developer,25,1,24
Lang,5000019,developer,21,1,20
Lang,5000020,developer,21,1,20
Lang,5000021,developer,21,2,19
Lang,5000029,developer,21,1,20
Lang,5000030,developer,21,1,20
Lang,5000031,developer,21,1,20
Lang,5100184,developer,52,1,51
Lang,5200061,developer,14,1,13
Lang,5200062,developer,14,1,13
Lang,5200063,developer,14,1,13
Lang,5400057,developer,12,2,10
Lang,5400058,developer,12,1,11
Lang,5400059,developer,12,1,11
Lang,5400060,developer,12,1,11
Lang,5400061,developer,12,1,11
Lang,5400062,developer,12,1,11
Lang,5400063,developer,12,1,11
Lang,5400064,developer,12,1,11
Lang,5400065,developer,12,1,11
Lang,5500013,developer,6,1,5
Lang,5500014,developer,6,3,3
Lang,5600232,developer,19,1,18
Lang,5700127,developer,11,1,10
Lang,5800105,developer,74,3,71
Lang,5800106,developer,74,3,71
Lang,5800107,developer,74,3,71
Lang,5800108,developer,74,1,73
Lang,5800109,developer,74,3,71
Lang,5800110,developer,74,1,73
Lang,5800111,developer,74,1,73
Lang,5800112,developer,74,1,73
Lang,5800113,developer,74,1,73
Lang,5800114,developer,74,3,71
Lang,5800115,developer,74,1,73
Lang,5800116,developer,74,3,71
Lang,5900428,developer,182,3,179
Lang,5900429,developer,182,3,179
Lang,5900430,developer,182,3,179
Lang,6000960,developer,185,1,184
Lang,6000961,developer,185,2,183
Lang,6101021,developer,184,7,177
Lang,6101022,developer,184,3,181
Lang,6101023,developer,184,2,182
Lang,6101024,developer,184,3,181
Lang,6101025,developer,184,2,182
Lang,6101026,developer,184,4,180
Lang,6101027,developer,184,8,176
Lang,6101028,developer,184,2,182
Lang,6101029,developer,184,4,180
Lang,6101030,developer,184,2,182
Lang,6200299,developer,42,2,40
Lang,6200300,developer,42,2,40
Lang,6200301,developer,42,2,40
Lang,6200302,developer,42,1,41
Lang,6200303,developer,42,1,41
Lang,6200304,developer,42,1,41
Lang,6200305,developer,42,1,41
Lang,6200387,developer,42,2,40
Lang,6200393,developer,42,3,39
Lang,6200394,developer,42,3,39
Lang,6200395,developer,42,3,39
Lang,6200396,developer,42,1,41
Lang,6200397,developer,42,1,41
Lang,6200398,developer,42,1,41
Lang,6200399,developer,42,1,41
Lang,6200400,developer,42,1,41
Lang,6200401,developer,42,2,40
Lang,6200402,developer,42,2,40
Lang,6400009,developer,73,1,72
Lang,6400010,developer,73,1,72
Lang,6400011,developer,73,3,70
Lang,6500119,developer,21,4,17
Lang,6500120,developer,21,2,19
Lang,6500121,developer,21,1,20
Lang,6500122,developer,21,1,20
Lang,6500123,developer,21,5,16
Lang,6500124,developer,21,5,16
Lang,6500125,developer,21,1,20
Lang,6500126,developer,21,1,20
Lang,6500127,developer,21,2,19
Lang,6500128,developer,21,2,19
Lang,6500129,developer,21,1,20
Lang,6500130,developer,21,2,19
Lang,6500131,developer,21,2,19
Lang,6500132,developer,21,2,19
Lang,6500133,developer,21,1,20
Lang,6500134,developer,21,1,20
Lang,6500135,developer,21,5,16
Lang,6500136,developer,21,5,16
Lang,6500137,developer,21,3,18
Lang,6500138,developer,21,5,16
Lang,6500139,developer,21,1,20
Lang,6500140,developer,21,1,20
Lang,6500141,developer,21,3,18
Lang,6500142,developer,21,3,18
Lang,6500143,developer,21,3,18
Lang,6500144,developer,21,1,20
Lang,6500145,developer,21,2,19
Lang,6500146,developer,21,2,19
Lang,6500147,developer,21,1,20
Lang,6500148,developer,21,2,19
Lang,6500149,developer,21,2,19
Lang,6500150,developer,21,2,19
Lang,6500151,developer,21,1,20
Lang,6500152,developer,21,1,20
Lang,6500153,developer,21,3,18
Lang,6500154,developer,21,1,20
Lang,6500155,developer,21,3,18
Lang,6500156,developer,21,1,20
Lang,6500157,developer,21,2,19
Lang,6500158,developer,21,1,20
Lang,6500159,developer,21,4,17
Lang,6500160,developer,21,1,20
Lang,6500161,developer,21,1,20
Lang,6500162,developer,21,5,16
Lang,6500163,developer,21,5,16
Lang,6500164,developer,21,2,19
Lang,6500165,developer,21,5,16
Lang,6500166,developer,21,1,20
Lang,6500167,developer,21,1,20
Lang,6500168,developer,21,3,18
Lang,6500169,developer,21,3,18
Lang,6500170,developer,21,3,18
Lang,6500171,developer,21,1,20
Lang,6500172,developer,21,1,20
Lang,6500173,developer,21,1,20
Lang,6500174,developer,21,1,20
Lang,6500175,developer,21,1,20
Lang,6500176,developer,21,1,20
Lang,6500177,developer,21,1,20
Lang,6500178,developer,21,1,20
Lang,6500179,developer,21,1,20
Lang,6500180,developer,21,1,20
Lang,6500181,developer,21,3,18
Lang,6500182,developer,21,1,20
Lang,6500183,developer,21,3,18
Lang,6500184,developer,21,1,20
Lang,6500185,developer,21,3,18
Lang,6500186,developer,21,1,20
Lang,6500187,developer,21,1,20
Lang,6500188,developer,21,5,16
Lang,6500189,developer,21,5,16
Lang,6500190,developer,21,3,18
Lang,6500191,developer,21,5,16
Lang,6500192,developer,21,1,20
Lang,6500193,developer,21,1,20
Lang,6500194,developer,21,1,20
Lang,6500195,developer,21,1,20
Lang,6500294,developer,21,4,17
Lang,6500295,developer,21,1,20
Lang,6500296,developer,21,4,17
Lang,6500297,developer,21,1,20
Math,1,developer,305,2,303
Math,2,developer,16,1,15
Math,3,developer,1065,1,1064
Math,4,developer,52,2,50
Math,5,developer,241,1,240
Math,6,developer,228,28,200
Math,7,developer,168,1,167
Math,8,developer,22,1,21
Math,9,developer,35,1,34
Math,10,developer,351,1,350
Math,11,developer,10,1,9
Math,12,developer,656,3,653
Math,13,developer,88,1,87
Math,14,developer,92,1,91
Math,15,developer,2792,1,2791
Math,16,developer,2790,2,2788
Math,17,developer,81,1,80
Math,18,developer,26,1,25
Math,19,developer,25,1,24
Math,20,developer,24,1,23
Math,21,developer,24,2,22
Math,22,developer,87,2,85
Math,23,developer,17,1,16
Math,24,developer,16,1,15
Math,25,developer,7,1,6
Math,26,developer,209,1,208
Math,27,developer,209,1,208
Math,28,developer,26,1,25
Math,29,developer,76,3,73
Math,30,developer,3,1,2
Math,31,developer,311,2,309
Math,32,developer,23,1,22
Math,33,developer,28,1,27
Math,34,developer,24,1,23
Math,35,developer,12,4,8
Math,36,developer,88,2,86
Math,37,developer,287,4,283
Math,38,developer,17,1,16
Math,39,developer,69,1,68
Math,40,developer,89,1,88
Math,41,developer,221,1,220
Math,42,developer,27,1,26
Math,43,developer,78,6,72
Math,44,developer,162,1,161
Math,45,developer,433,1,432
Math,46,developer,190,2,188
Math,47,developer,190,2,188
Math,48,developer,36,1,35
Math,49,developer,35,1,34
Math,50,developer,36,1,35
Math,51,developer,36,1,35
Math,52,developer,28,1,27
Math,53,developer,167,1,166
Math,54,developer,63,1,62
Math,55,developer,88,1,87
Math,56,developer,5,1,4
Math,57,developer,4,1,3
Math,58,developer,8,1,7
Math,59,developer,1513,1,1512
Math,60,developer,26,1,25
Math,61,developer,12,1,11
Math,62,developer,2,1,1
Math,63,developer,760,1,759
Math,64,developer,54,2,52
Math,65,developer,75,1,74
Math,66,developer,10,4,6
Math,67,developer,2,1,1
Math,68,developer,44,2,42
Math,69,developer,15,2,13
Math,70,developer,16,1,15
Math,71,developer,114,2,112
Math,72,developer,152,1,151
Math,73,developer,166,1,165
Math,74,developer,56,1,55
Math,75,developer,8,1,7
Math,76,developer,17,2,15
Math,77,developer,346,2,344
Math,78,developer,116,1,115
Math,79,developer,409,1,408
Math,80,developer,36,1,35
Math,81,developer,35,1,34
Math,82,developer,14,1,13
Math,83,developer,17,1,16
Math,84,developer,5,2,3
Math,85,developer,92,1,91
Math,86,developer,12,2,10
Math,87,developer,16,1,15
Math,88,developer,15,1,14
Math,89,developer,7,1,6
Math,90,developer,7,1,6
Math,91,developer,56,1,55
Math,92,developer,203,1,202
Math,93,developer,202,1,201
Math,94,developer,202,1,201
Math,95,developer,22,1,21
Math,96,developer,149,1,148
Math,97,developer,59,1,58
Math,98,developer,113,2,111
Math,99,developer,290,2,288
Math,100,developer,48,1,47
Math,101,developer,70,2,68
Math,102,developer,30,6,24
Math,103,developer,20,1,19
Math,104,developer,91,1,90
Math,105,developer,9,1,8
Math,106,developer,16,1,15
Math,100167,developer,305,1,304
Math,100168,developer,305,1,304
Math,100169,developer,305,1,304
Math,100170,developer,305,1,304
Math,100171,developer,305,1,304
Math,100172,developer,305,1,304
Math,100422,developer,305,1,304
Math,100423,developer,305,1,304
Math,100424,developer,305,1,304
Math,100425,developer,305,1,304
Math,100426,developer,305,1,304
Math,100427,developer,305,1,304
Math,100428,developer,305,1,304
Math,100429,developer,305,1,304
Math,200125,developer,16,3,13
Math,200126,developer,16,3,13
Math,200127,developer,16,3,13
Math,200128,developer,16,4,12
Math,200129,developer,16,3,13
Math,200130,developer,16,3,13
Math,200131,developer,16,3,13
Math,200132,developer,16,3,13
Math,300277,developer,1065,1,1064
Math,300278,developer,1065,1,1064
Math,300279,developer,1065,7,1058
Math,300280,developer,1065,1,1064
Math,300281,developer,1065,1,1064
Math,300282,developer,1065,1,1064
Math,300283,developer,1065,1,1064
Math,300284,developer,1065,1,1064
Math,300285,developer,1065,1,1064
Math,300286,developer,1065,1,1064
Math,300287,developer,1065,1,1064
Math,300288,developer,1065,1,1064
Math,400010,developer,52,1,51
Math,400036,developer,52,1,51
Math,500221,developer,241,1,240
Math,600002,developer,228,214,14
Math,600043,developer,228,13,215
Math,600044,developer,228,11,217
Math,600049,developer,228,13,215
Math,600050,developer,228,9,219
Math,600107,developer,228,2,226
Math,600108,developer,228,2,226
Math,600109,developer,228,1,227
Math,600110,developer,228,2,226
Math,600111,developer,228,5,223
Math,600112,developer,228,2,226
Math,600113,developer,228,10,218
Math,600114,developer,228,2,226
Math,600115,developer,228,6,222
Math,600116,developer,228,10,218
Math,600117,developer,228,1,227
Math,600118,developer,228,2,226
Math,600119,developer,228,10,218
Math,600207,developer,228,16,212
Math,601074,developer,228,1,227
Math,601212,developer,228,27,201
Math,601213,developer,228,27,201
Math,601214,developer,228,26,202
Math,601231,developer,228,26,202
Math,601252,developer,228,30,198
Math,601253,developer,228,2,226
Math,601348,developer,228,1,227
Math,700071,developer,168,2,166
Math,700072,developer,168,9,159
Math,700073,developer,168,10,158
Math,700074,developer,168,9,159
Math,700083,developer,168,2,166
Math,700084,developer,168,10,158
Math,700085,developer,168,13,155
Math,700086,developer,168,10,158
Math,700087,developer,168,10,158
Math,700088,developer,168,13,155
Math,800046,developer,22,1,21
Math,900022,developer,35,1,34
Math,900023,developer,35,1,34
Math,1001830,developer,351,1,350
Math,1100036,developer,10,3,7
Math,1100037,developer,10,3,7
Math,1100038,developer,10,3,7
Math,1100039,developer,10,3,7
Math,1100040,developer,10,3,7
Math,1100041,developer,10,3,7
Math,1100042,developer,10,3,7
Math,1100043,developer,10,3,7
Math,1100044,developer,10,3,7
Math,1100045,developer,10,2,8
Math,1100046,developer,10,3,7
Math,1100047,developer,10,3,7
Math,1100048,developer,10,2,8
Math,1100049,developer,10,2,8
Math,1100050,developer,10,2,8
Math,1100051,developer,10,2,8
Math,1100052,developer,10,2,8
Math,1100053,developer,10,3,7
Math,1100054,developer,10,3,7
Math,1100055,developer,10,2,8
Math,1100056,developer,10,3,7
Math,1100057,developer,10,3,7
Math,1100058,developer,10,3,7
Math,1100059,developer,10,3,7
Math,1300074,developer,88,84,4
Math,1300075,developer,88,84,4
Math,1300076,developer,88,52,36
Math,1300077,developer,88,84,4
Math,1300078,developer,88,84,4
Math,1300079,developer,88,73,15
Math,1300080,developer,88,83,5
Math,1400001,developer,92,87,5
Math,1400043,developer,92,87,5
Math,1400044,developer,92,87,5
Math,1400045,developer,92,53,39
Math,1400046,developer,92,87,5
Math,1400047,developer,92,87,5
Math,1400048,developer,92,76,16
Math,1400049,developer,92,86,6
Math,1503755,developer,2792,1,2791
Math,1503756,developer,2792,62,2730
Math,1503757,developer,2792,61,2731
Math,1503758,developer,2792,1,2791
Math,1503759,developer,2792,62,2730
Math,1503760,developer,2792,1,2791
Math,1503761,developer,2792,1,2791
Math,1503762,developer,2792,61,2731
Math,1600399,developer,2790,1,2789
Math,1600400,developer,2790,6,2784
Math,1600401,developer,2790,6,2784
Math,1600402,developer,2790,6,2784
Math,1600403,developer,2790,1,2789
Math,1600404,developer,2790,6,2784
Math,1600405,developer,2790,6,2784
Math,1600406,developer,2790,6,2784
Math,1600407,developer,2790,6,2784
Math,1600408,developer,2790,1,2789
Math,1600409,developer,2790,1,2789
Math,1600410,developer,2790,6,2784
Math,1600411,developer,2790,6,2784
Math,1600412,developer,2790,6,2784
Math,1600413,developer,2790,1,2789
Math,1600414,developer,2790,6,2784
Math,1600415,developer,2790,6,2784
Math,1600422,developer,2790,4,2786
Math,1600423,developer,2790,18,2772
Math,1600424,developer,2790,18,2772
Math,1600425,developer,2790,6,2784
Math,1600426,developer,2790,1,2789
Math,1600427,developer,2790,6,2784
Math,1600428,developer,2790,6,2784
Math,1600429,developer,2790,6,2784
Math,1600430,developer,2790,6,2784
Math,1600431,developer,2790,6,2784
Math,1600432,developer,2790,1,2789
Math,1600433,developer,2790,6,2784
Math,1600434,developer,2790,6,2784
Math,1600435,developer,2790,6,2784
Math,1600436,developer,2790,1,2789
Math,1600437,developer,2790,1,2789
Math,1600438,developer,2790,6,2784
Math,1600439,developer,2790,6,2784
Math,1600440,developer,2790,6,2784
Math,1600441,developer,2790,1,2789
Math,1600442,developer,2790,6,2784
Math,1600443,developer,2790,6,2784
Math,1600611,developer,2790,1,2789
Math,1600612,developer,2790,6,2784
Math,1600613,developer,2790,6,2784
Math,1600614,developer,2790,6,2784
Math,1600615,developer,2790,1,2789
Math,1600616,developer,2790,6,2784
Math,1600617,developer,2790,6,2784
Math,1600618,developer,2790,6,2784
Math,1600619,developer,2790,6,2784
Math,1600620,developer,2790,1,2789
Math,1600621,developer,2790,1,2789
Math,1600622,developer,2790,6,2784
Math,1600623,developer,2790,6,2784
Math,1600624,developer,2790,6,2784
Math,1600625,developer,2790,1,2789
Math,1600626,developer,2790,6,2784
Math,1600627,developer,2790,6,2784
Math,1600634,developer,2790,5,2785
Math,1600635,developer,2790,18,2772
Math,1600636,developer,2790,18,2772
Math,1600637,developer,2790,6,2784
Math,1600638,developer,2790,1,2789
Math,1600639,developer,2790,6,2784
Math,1600640,developer,2790,6,2784
Math,1600641,developer,2790,6,2784
Math,1600642,developer,2790,6,2784
Math,1600643,developer,2790,6,2784
Math,1600644,developer,2790,1,2789
Math,1600645,developer,2790,6,2784
Math,1600646,developer,2790,6,2784
Math,1600647,developer,2790,6,2784
Math,1600648,developer,2790,6,2784
Math,1600649,developer,2790,1,2789
Math,1600650,developer,2790,6,2784
Math,1600651,developer,2790,1,2789
Math,1600652,developer,2790,6,2784
Math,1600653,developer,2790,6,2784
Math,1600654,developer,2790,6,2784
Math,1600655,developer,2790,1,2789
Math,1600656,developer,2790,6,2784
Math,1800936,developer,26,2,24
Math,1800937,developer,26,1,25
Math,1800938,developer,26,3,23
Math,1800939,developer,26,2,24
Math,1800940,developer,26,2,24
Math,1800959,developer,26,3,23
Math,1800960,developer,26,3,23
Math,1800961,developer,26,3,23
Math,1800962,developer,26,3,23
Math,1800963,developer,26,3,23
Math,1900169,developer,25,1,24
Math,1900170,developer,25,5,20
Math,1900171,developer,25,4,21
Math,1900172,developer,25,1,24
Math,1900173,developer,25,5,20
Math,1900174,developer,25,1,24
Math,1900175,developer,25,5,20
Math,1900176,developer,25,1,24
Math,1900177,developer,25,1,24
Math,1900178,developer,25,1,24
Math,1900179,developer,25,1,24
Math,1900180,developer,25,4,21
Math,1900181,developer,25,1,24
Math,1900182,developer,25,1,24
Math,2000763,developer,24,1,23
Math,2100004,developer,24,4,20
Math,2100011,developer,24,3,21
Math,2100017,developer,24,2,22
Math,2100018,developer,24,3,21
Math,2100019,developer,24,3,21
Math,2100020,developer,24,3,21
Math,2100021,developer,24,3,21
Math,2100022,developer,24,1,23
Math,2100023,developer,24,3,21
Math,2100024,developer,24,3,21
Math,2100025,developer,24,4,20
Math,2100026,developer,24,3,21
Math,2100027,developer,24,3,21
Math,2100044,developer,24,3,21
Math,2100045,developer,24,3,21
Math,2100046,developer,24,4,20
Math,2100047,developer,24,4,20
Math,2100048,developer,24,4,20
Math,2100049,developer,24,4,20
Math,2100060,developer,24,3,21
Math,2100061,developer,24,4,20
Math,2100062,developer,24,3,21
Math,2100063,developer,24,4,20
Math,2100064,developer,24,3,21
Math,2100065,developer,24,4,20
Math,2100066,developer,24,4,20
Math,2100067,developer,24,4,20
Math,2100068,developer,24,3,21
Math,2200196,developer,87,1,86
Math,2200269,developer,87,1,86
Math,2300287,developer,17,2,15
Math,2300291,developer,17,5,12
Math,2300328,developer,17,11,6
Math,2400288,developer,16,5,11
Math,2400326,developer,16,10,6
Math,2500206,developer,7,1,6
Math,2500207,developer,7,1,6
Math,2500208,developer,7,3,4
Math,2500209,developer,7,1,6
Math,2600031,developer,209,35,174
Math,2600032,developer,209,1,208
Math,2600080,developer,209,31,178
Math,2600081,developer,209,1,208
Math,2600082,developer,209,31,178
Math,2600083,developer,209,1,208
Math,2600084,developer,209,1,208
Math,2600085,developer,209,31,178
Math,2700307,developer,209,2,207
Math,2700308,developer,209,2,207
Math,2700309,developer,209,2,207
Math,2700310,developer,209,2,207
Math,2700311,developer,209,2,207
Math,2700312,developer,209,2,207
Math,2800057,developer,26,4,22
Math,2800058,developer,26,1,25
Math,2800059,developer,26,1,25
Math,2800060,developer,26,1,25
Math,2800061,developer,26,1,25
Math,2900095,developer,76,1,75
Math,2900096,developer,76,1,75
Math,2900097,developer,76,2,74
Math,2900098,developer,76,2,74
Math,2900099,developer,76,1,75
Math,2900100,developer,76,1,75
Math,2900101,developer,76,1,75
Math,2900102,developer,76,1,75
Math,2900103,developer,76,1,75
Math,2900114,developer,76,2,74
Math,2900115,developer,76,2,74
Math,2900116,developer,76,2,74
Math,2900117,developer,76,2,74
Math,2900118,developer,76,2,74
Math,2900119,developer,76,2,74
Math,2900120,developer,76,2,74
Math,2900121,developer,76,2,74
Math,2900122,developer,76,2,74
Math,2900123,developer,76,2,74
Math,2900124,developer,76,2,74
Math,2900125,developer,76,2,74
Math,2900126,developer,76,2,74
Math,3000063,developer,3,1,2
Math,3000064,developer,3,1,2
Math,3000065,developer,3,1,2
Math,3000066,developer,3,1,2
Math,3100011,developer,311,108,203
Math,3100015,developer,311,108,203
Math,3100016,developer,311,85,226
Math,3100017,developer,311,85,226
Math,3100018,developer,311,108,203
Math,3100019,developer,311,108,203
Math,3100020,developer,311,108,203
Math,3100021,developer,311,87,224
Math,3100022,developer,311,108,203
Math,3100023,developer,311,60,251
Math,3100024,developer,311,3,308
Math,3100025,developer,311,108,203
Math,3100026,developer,311,81,230
Math,3100027,developer,311,92,219
Math,3100028,developer,311,108,203
Math,3100029,developer,311,101,210
Math,3100030,developer,311,107,204
Math,3100031,developer,311,108,203
Math,3100032,developer,311,96,215
Math,3100033,developer,311,108,203
Math,3100034,developer,311,27,284
Math,3100036,developer,311,108,203
Math,3100037,developer,311,108,203
Math,3100038,developer,311,108,203
Math,3100039,developer,311,108,203
Math,3100040,developer,311,96,215
Math,3100041,developer,311,108,203
Math,3100042,developer,311,108,203
Math,3100043,developer,311,96,215
Math,3100044,developer,311,108,203
Math,3100045,developer,311,108,203
Math,3100046,developer,311,108,203
Math,3100047,developer,311,96,215
Math,3100048,developer,311,89,222
Math,3100049,developer,311,74,237
Math,3100050,developer,311,88,223
Math,3100051,developer,311,71,240
Math,3100052,developer,311,70,241
Math,3100064,developer,311,86,225
Math,3100065,developer,311,74,237
Math,3100066,developer,311,70,241
Math,3200007,developer,23,1,22
Math,3200008,developer,23,1,22
Math,3300234,developer,28,2,26
Math,3300235,developer,28,16,12
Math,3300236,developer,28,3,25
Math,3300237,developer,28,16,12
Math,3300238,developer,28,1,27
Math,3300239,developer,28,16,12
Math,3300240,developer,28,3,25
Math,3400035,developer,24,2,22
Math,3500001,developer,12,2,10
Math,3500002,developer,12,3,9
Math,3600237,developer,88,1,87
Math,3600238,developer,88,1,87
Math,3600239,developer,88,1,87
Math,3600240,developer,88,1,87
Math,3600241,developer,88,1,87
Math,3600242,developer,88,1,87
Math,3600243,developer,88,1,87
Math,3600244,developer,88,1,87
Math,3600245,developer,88,1,87
Math,3600261,developer,88,1,87
Math,3600262,developer,88,1,87
Math,3600263,developer,88,1,87
Math,3600264,developer,88,1,87
Math,3600265,developer,88,1,87
Math,3600266,developer,88,1,87
Math,3600267,developer,88,1,87
Math,3600268,developer,88,1,87
Math,3600269,developer,88,1,87
Math,3600270,developer,88,1,87
Math,3700491,developer,287,1,286
Math,3700492,developer,287,3,284
Math,3700494,developer,287,1,286
Math,3700495,developer,287,2,285
Math,3700496,developer,287,3,284
Math,3700497,developer,287,2,285
Math,3700498,developer,287,2,285
Math,3700499,developer,287,2,285
Math,3700500,developer,287,2,285
Math,3700501,developer,287,2,285
Math,3700502,developer,287,2,285
Math,3700503,developer,287,2,285
Math,3700504,developer,287,2,285
Math,3700505,developer,287,2,285
Math,3700506,developer,287,2,285
Math,3700507,developer,287,2,285
Math,3700508,developer,287,2,285
Math,3700509,developer,287,2,285
Math,3700510,developer,287,2,285
Math,3700535,developer,287,1,286
Math,3700536,developer,287,3,284
Math,3700538,developer,287,1,286
Math,3700539,developer,287,2,285
Math,3700540,developer,287,3,284
Math,3700541,developer,287,2,285
Math,3700542,developer,287,2,285
Math,3700543,developer,287,2,285
Math,3700544,developer,287,2,285
Math,3700545,developer,287,2,285
Math,3700546,developer,287,2,285
Math,3700547,developer,287,2,285
Math,3700548,developer,287,2,285
Math,3700549,developer,287,2,285
Math,3700550,developer,287,2,285
Math,3700551,developer,287,2,285
Math,3700552,developer,287,2,285
Math,3700553,developer,287,2,285
Math,3700554,developer,287,2,285
Math,3900116,developer,69,1,68
Math,3900117,developer,69,2,67
Math,3900118,developer,69,1,68
Math,3900120,developer,69,1,68
Math,3900122,developer,69,2,67
Math,3900126,developer,69,1,68
Math,3900131,developer,69,1,68
Math,4000172,developer,89,1,88
Math,4000173,developer,89,1,88
Math,4000174,developer,89,2,87
Math,4000175,developer,89,3,86
Math,4000176,developer,89,2,87
Math,4000177,developer,89,1,88
Math,4000178,developer,89,1,88
Math,4000179,developer,89,1,88
Math,4000180,developer,89,1,88
Math,4000181,developer,89,1,88
Math,4000182,developer,89,1,88
Math,4000183,developer,89,1,88
Math,4000184,developer,89,1,88
Math,4000185,developer,89,2,87
Math,4000186,developer,89,2,87
Math,4000187,developer,89,2,87
Math,4000188,developer,89,2,87
Math,4000189,developer,89,1,88
Math,4000190,developer,89,2,87
Math,4000191,developer,89,2,87
Math,4000192,developer,89,2,87
Math,4000193,developer,89,2,87
Math,4000194,developer,89,2,87
Math,4000195,developer,89,1,88
Math,4000196,developer,89,1,88
Math,4000197,developer,89,1,88
Math,4000198,developer,89,1,88
Math,4000199,developer,89,2,87
Math,4000200,developer,89,3,86
Math,4000201,developer,89,3,86
Math,4000202,developer,89,1,88
Math,4000203,developer,89,2,87
Math,4000204,developer,89,2,87
Math,4000205,developer,89,2,87
Math,4000206,developer,89,2,87
Math,4000207,developer,89,2,87
Math,4000208,developer,89,2,87
Math,4000209,developer,89,2,87
Math,4000212,developer,89,3,86
Math,4000213,developer,89,3,86
Math,4000214,developer,89,3,86
Math,4000215,developer,89,3,86
Math,4000216,developer,89,3,86
Math,4000217,developer,89,3,86
Math,4000218,developer,89,3,86
Math,4000219,developer,89,3,86
Math,4000220,developer,89,3,86
Math,4000221,developer,89,3,86
Math,4000222,developer,89,2,87
Math,4000223,developer,89,3,86
Math,4000224,developer,89,2,87
Math,4000225,developer,89,3,86
Math,4000226,developer,89,3,86
Math,4000227,developer,89,3,86
Math,4000228,developer,89,3,86
Math,4000229,developer,89,3,86
Math,4000230,developer,89,3,86
Math,4000231,developer,89,2,87
Math,4000232,developer,89,3,86
Math,4000233,developer,89,3,86
Math,4000234,developer,89,3,86
Math,4000235,developer,89,3,86
Math,4000236,developer,89,2,87
Math,4000237,developer,89,3,86
Math,4000238,developer,89,3,86
Math,4000239,developer,89,4,85
Math,4000240,developer,89,3,86
Math,4000241,developer,89,3,86
Math,4000242,developer,89,4,85
Math,4000243,developer,89,3,86
Math,4000244,developer,89,3,86
Math,4100154,developer,221,1,220
Math,4100155,developer,221,2,219
Math,4100156,developer,221,3,218
Math,4100157,developer,221,2,219
Math,4100158,developer,221,2,219
Math,4100159,developer,221,3,218
Math,4200331,developer,27,7,20
Math,4200332,developer,27,11,16
Math,4200333,developer,27,1,26
Math,4200334,developer,27,16,11
Math,4200335,developer,27,1,26
Math,4200336,developer,27,7,20
Math,4200337,developer,27,1,26
Math,4200338,developer,27,16,11
Math,4200339,developer,27,7,20
Math,4200340,developer,27,1,26
Math,4200341,developer,27,2,25
Math,4200342,developer,27,16,11
Math,4300030,developer,78,2,76
Math,4400087,developer,162,1,161
Math,4500001,developer,433,1,432
Math,4500002,developer,433,1,432
Math,4500003,developer,433,1,432
Math,4500004,developer,433,1,432
Math,4500005,developer,433,1,432
Math,4500006,developer,433,1,432
Math,4500007,developer,433,30,403
Math,4600107,developer,190,4,186
Math,4600195,developer,190,1,189
Math,4700028,developer,190,4,186
Math,4700029,developer,190,3,187
Math,4700030,developer,190,4,186
Math,4700031,developer,190,7,183
Math,4700032,developer,190,3,187
Math,4700033,developer,190,3,187
Math,4700034,developer,190,3,187
Math,4700035,developer,190,2,188
Math,4700036,developer,190,3,187
Math,4700037,developer,190,4,186
Math,4700038,developer,190,3,187
Math,4700039,developer,190,2,188
Math,4700040,developer,190,8,182
Math,4700112,developer,190,3,187
Math,4700113,developer,190,11,179
Math,4700114,developer,190,4,186
Math,4700199,developer,190,1,189
Math,4800074,developer,36,6,30
Math,4800075,developer,36,5,31
Math,4800076,developer,36,1,35
Math,4900091,developer,35,2,33
Math,4900100,developer,35,1,34
Math,4900103,developer,35,2,33
Math,4900112,developer,35,1,34
Math,5000073,developer,36,7,29
Math,5100074,developer,36,1,35
Math,5100075,developer,36,1,35
Math,5100076,developer,36,1,35
Math,5100077,developer,36,1,35
Math,5100078,developer,36,1,35
Math,5100079,developer,36,1,35
Math,5100080,developer,36,1,35
Math,5100081,developer,36,1,35
Math,5100082,developer,36,1,35
Math,5100083,developer,36,1,35
Math,5100084,developer,36,1,35
Math,5100085,developer,36,1,35
Math,5100086,developer,36,1,35
Math,5100087,developer,36,1,35
Math,5100088,developer,36,1,35
Math,5100089,developer,36,1,35
Math,5100090,developer,36,1,35
Math,5100091,developer,36,1,35
Math,5100092,developer,36,7,29
Math,5200589,developer,28,1,27
Math,5200590,developer,28,1,27
Math,5200591,developer,28,1,27
Math,5200592,developer,28,1,27
Math,5200593,developer,28,1,27
Math,5200594,developer,28,1,27
Math,5200595,developer,28,1,27
Math,5200601,developer,28,1,27
Math,5200602,developer,28,1,27
Math,5200603,developer,28,1,27
Math,5200604,developer,28,1,27
Math,5200605,developer,28,1,27
Math,5200608,developer,28,1,27
Math,5200609,developer,28,1,27
Math,5200610,developer,28,1,27
Math,5300075,developer,167,1,166
Math,5300076,developer,167,15,152
Math,5300077,developer,167,3,164
Math,5500491,developer,88,4,84
Math,5500492,developer,88,4,84
Math,5500493,developer,88,1,87
Math,5500494,developer,88,3,85
Math,5500495,developer,88,4,84
Math,5500496,developer,88,2,86
Math,5500497,developer,88,1,87
Math,5500498,developer,88,1,87
Math,5500499,developer,88,2,86
Math,5500500,developer,88,4,84
Math,5500501,developer,88,1,87
Math,5500502,developer,88,1,87
Math,5500503,developer,88,1,87
Math,5500504,developer,88,1,87
Math,5500505,developer,88,1,87
Math,5500506,developer,88,1,87
Math,5500507,developer,88,4,84
Math,5500508,developer,88,1,87
Math,5500509,developer,88,4,84
Math,5500510,developer,88,1,87
Math,5500511,developer,88,4,84
Math,5500512,developer,88,4,84
Math,5500513,developer,88,4,84
Math,5500514,developer,88,4,84
Math,5500515,developer,88,2,86
Math,5500516,developer,88,1,87
Math,5500517,developer,88,1,87
Math,5500518,developer,88,2,86
Math,5500519,developer,88,2,86
Math,5500520,developer,88,1,87
Math,5500521,developer,88,1,87
Math,5500522,developer,88,2,86
Math,5500523,developer,88,2,86
Math,5500524,developer,88,1,87
Math,5500525,developer,88,1,87
Math,5500526,developer,88,2,86
Math,5500527,developer,88,1,87
Math,5500528,developer,88,1,87
Math,5500529,developer,88,2,86
Math,5500530,developer,88,1,87
Math,5500531,developer,88,1,87
Math,5500532,developer,88,1,87
Math,5500533,developer,88,4,84
Math,5500534,developer,88,1,87
Math,5500535,developer,88,1,87
Math,5500536,developer,88,4,84
Math,5500537,developer,88,1,87
Math,5500538,developer,88,1,87
Math,5500539,developer,88,1,87
Math,5500540,developer,88,1,87
Math,5500541,developer,88,1,87
Math,5500542,developer,88,1,87
Math,5500543,developer,88,2,86
Math,5500544,developer,88,1,87
Math,5500545,developer,88,1,87
Math,5500546,developer,88,1,87
Math,5500547,developer,88,4,84
Math,5500548,developer,88,1,87
Math,5500549,developer,88,1,87
Math,5500550,developer,88,1,87
Math,5500551,developer,88,1,87
Math,5500552,developer,88,1,87
Math,5500553,developer,88,4,84
Math,5500554,developer,88,4,84
Math,5500555,developer,88,4,84
Math,5500556,developer,88,4,84
Math,5500557,developer,88,3,85
Math,5500558,developer,88,4,84
Math,5500559,developer,88,3,85
Math,5500560,developer,88,4,84
Math,5500561,developer,88,4,84
Math,5500562,developer,88,4,84
Math,5500563,developer,88,4,84
Math,5500564,developer,88,3,85
Math,5500565,developer,88,2,86
Math,5500566,developer,88,4,84
Math,5500567,developer,88,3,85
Math,5500568,developer,88,4,84
Math,5500569,developer,88,4,84
Math,5500570,developer,88,4,84
Math,5500571,developer,88,4,84
Math,5500572,developer,88,2,86
Math,5500573,developer,88,3,85
Math,5500574,developer,88,4,84
Math,5500575,developer,88,3,85
Math,5500576,developer,88,4,84
Math,5500577,developer,88,2,86
Math,5500578,developer,88,4,84
Math,5500579,developer,88,4,84
Math,5500580,developer,88,1,87
Math,5500581,developer,88,3,85
Math,5500582,developer,88,4,84
Math,5500583,developer,88,4,84
Math,5500584,developer,88,2,86
Math,5500585,developer,88,4,84
Math,5500586,developer,88,4,84
Math,5500587,developer,88,2,86
Math,5500588,developer,88,4,84
Math,5500589,developer,88,3,85
Math,5500590,developer,88,4,84
Math,5500591,developer,88,4,84
Math,5500592,developer,88,3,85
Math,5500593,developer,88,3,85
Math,5500594,developer,88,4,84
Math,5500595,developer,88,4,84
Math,5500596,developer,88,1,87
Math,5500597,developer,88,4,84
Math,5500598,developer,88,4,84
Math,5500599,developer,88,3,85
Math,5500600,developer,88,4,84
Math,5500601,developer,88,3,85
Math,5500602,developer,88,4,84
Math,5500603,developer,88,4,84
Math,5500604,developer,88,2,86
Math,5500605,developer,88,2,86
Math,5500606,developer,88,4,84
Math,5500607,developer,88,4,84
Math,5500608,developer,88,2,86
Math,5500609,developer,88,4,84
Math,5500610,developer,88,3,85
Math,5500611,developer,88,2,86
Math,5500612,developer,88,4,84
Math,5600100,developer,5,1,4
Math,5600101,developer,5,1,4
Math,5600102,developer,5,1,4
Math,5600103,developer,5,1,4
Math,5600104,developer,5,1,4
Math,5700033,developer,4,1,3
Math,5800008,developer,8,6,2
Math,6000047,developer,26,7,19
Math,6000048,developer,26,7,19
Math,6000049,developer,26,7,19
Math,6000050,developer,26,1,25
Math,6000051,developer,26,1,25
Math,6000052,developer,26,1,25
Math,6000053,developer,26,7,19
Math,6000054,developer,26,1,25
Math,6000055,developer,26,1,25
Math,6000056,developer,26,1,25
Math,6000057,developer,26,1,25
Math,6000058,developer,26,1,25
Math,6000059,developer,26,1,25
Math,6000060,developer,26,1,25
Math,6200006,developer,2,1,1
Math,6200007,developer,2,1,1
Math,6200008,developer,2,1,1
Math,6200009,developer,2,1,1
Math,6200010,developer,2,1,1
Math,6200011,developer,2,1,1
Math,6200016,developer,2,1,1
Math,6200017,developer,2,1,1
Math,6200018,developer,2,2,0
Math,6200019,developer,2,2,0
Math,6200020,developer,2,2,0
Math,6200021,developer,2,2,0
Math,6200022,developer,2,1,1
Math,6200023,developer,2,1,1
Math,6200024,developer,2,2,0
Math,6200025,developer,2,1,1
Math,6200026,developer,2,1,1
Math,6200027,developer,2,2,0
Math,6200028,developer,2,1,1
Math,6300331,developer,760,1,759
Math,6400026,developer,54,51,3
Math,6400033,developer,54,42,12
Math,6400034,developer,54,51,3
Math,6400035,developer,54,51,3
Math,6400036,developer,54,46,8
Math,6400041,developer,54,46,8
Math,6400098,developer,54,3,51
Math,6400099,developer,54,1,53
Math,6400100,developer,54,1,53
Math,6400101,developer,54,9,45
Math,6400102,developer,54,46,8
Math,6400128,developer,54,46,8
Math,6400348,developer,54,13,41
Math,6400349,developer,54,34,20
Math,6400350,developer,54,49,5
Math,6400351,developer,54,1,53
Math,6400352,developer,54,1,53
Math,6400353,developer,54,1,53
Math,6500049,developer,75,17,58
Math,6500050,developer,75,18,57
Math,6500051,developer,75,41,34
Math,6500052,developer,75,44,31
Math,6500059,developer,75,42,33
Math,6500060,developer,75,28,47
Math,6500061,developer,75,20,55
Math,6500062,developer,75,40,35
Math,6500063,developer,75,12,63
Math,6500064,developer,75,40,35
Math,6500065,developer,75,43,32
Math,6500066,developer,75,3,72
Math,6500067,developer,75,20,55
Math,6600014,developer,10,7,3
Math,6600015,developer,10,7,3
Math,6600016,developer,10,7,3
Math,6600020,developer,10,6,4
Math,6600021,developer,10,6,4
Math,6600022,developer,10,6,4
Math,6600023,developer,10,4,6
Math,6600024,developer,10,4,6
Math,6600025,developer,10,4,6
Math,6600026,developer,10,8,2
Math,6600037,developer,10,7,3
Math,6600038,developer,10,7,3
Math,6600039,developer,10,2,8
Math,6600282,developer,10,9,1
Math,6600283,developer,10,8,2
Math,6600284,developer,10,2,8
Math,6600332,developer,10,2,8
Math,6600334,developer,10,3,7
Math,6700006,developer,2,1,1
Math,6700007,developer,2,1,1
Math,6700008,developer,2,1,1
Math,6800003,developer,44,20,24
Math,6800031,developer,44,2,42
Math,6800033,developer,44,1,43
Math,6800107,developer,44,11,33
Math,6800153,developer,44,34,10
Math,6800356,developer,44,41,3
Math,6800357,developer,44,1,43
Math,6800358,developer,44,1,43
Math,6800359,developer,44,1,43
Math,6800386,developer,44,28,16
Math,6900083,developer,15,6,9
Math,6900084,developer,15,6,9
Math,6900085,developer,15,4,11
Math,6900086,developer,15,5,10
Math,6900087,developer,15,4,11
Math,6900088,developer,15,4,11
Math,6900089,developer,15,5,10
Math,6900090,developer,15,6,9
Math,7000010,developer,16,1,15
Math,7100140,developer,114,1,113
Math,7100141,developer,114,1,113
Math,7100142,developer,114,1,113
Math,7100143,developer,114,1,113
Math,7100144,developer,114,1,113
Math,7100145,developer,114,1,113
Math,7100146,developer,114,1,113
Math,7100147,developer,114,1,113
Math,7100388,developer,114,1,113
Math,7100389,developer,114,1,113
Math,7100390,developer,114,1,113
Math,7100391,developer,114,1,113
Math,7100392,developer,114,1,113
Math,7100393,developer,114,1,113
Math,7100394,developer,114,1,113
Math,7100395,developer,114,1,113
Math,7300028,developer,166,1,165
Math,7300029,developer,166,1,165
Math,7300030,developer,166,1,165
Math,7400079,developer,56,48,8
Math,7400082,developer,56,42,14
Math,7400083,developer,56,42,14
Math,7400085,developer,56,11,45
Math,7400086,developer,56,11,45
Math,7400091,developer,56,12,44
Math,7400094,developer,56,6,50
Math,7400095,developer,56,6,50
Math,7400097,developer,56,1,55
Math,7400098,developer,56,1,55
Math,7500045,developer,8,1,7
Math,7600085,developer,17,10,7
Math,7600086,developer,17,11,6
Math,7600087,developer,17,11,6
Math,7600088,developer,17,11,6
Math,7600089,developer,17,11,6
Math,7600090,developer,17,11,6
Math,7600091,developer,17,11,6
Math,7600092,developer,17,11,6
Math,7600093,developer,17,11,6
Math,7600094,developer,17,11,6
Math,7600095,developer,17,7,10
Math,7600096,developer,17,10,7
Math,7600097,developer,17,8,9
Math,7600098,developer,17,7,10
Math,7600099,developer,17,10,7
Math,7600100,developer,17,7,10
Math,7600105,developer,17,8,9
Math,7600106,developer,17,11,6
Math,7600107,developer,17,7,10
Math,7600111,developer,17,7,10
Math,7600112,developer,17,7,10
Math,7600113,developer,17,7,10
Math,7600114,developer,17,7,10
Math,7600115,developer,17,7,10
Math,7600116,developer,17,7,10
Math,7600117,developer,17,7,10
Math,7600118,developer,17,7,10
Math,7600150,developer,17,5,12
Math,7600151,developer,17,5,12
Math,7600152,developer,17,5,12
Math,7600153,developer,17,5,12
Math,7600154,developer,17,5,12
Math,7600155,developer,17,5,12
Math,7600156,developer,17,5,12
Math,7600157,developer,17,5,12
Math,7600158,developer,17,5,12
Math,7600209,developer,17,2,15
Math,7600210,developer,17,2,15
Math,7600211,developer,17,2,15
Math,7600212,developer,17,2,15
Math,7600213,developer,17,2,15
Math,7600214,developer,17,2,15
Math,7600215,developer,17,2,15
Math,7600216,developer,17,2,15
Math,7600217,developer,17,2,15
Math,7600218,developer,17,2,15
Math,7600219,developer,17,2,15
Math,7600220,developer,17,2,15
Math,7600221,developer,17,2,15
Math,7600222,developer,17,2,15
Math,7600223,developer,17,2,15
Math,7600224,developer,17,2,15
Math,7600229,developer,17,2,15
Math,7600230,developer,17,2,15
Math,7600231,developer,17,2,15
Math,7600235,developer,17,2,15
Math,7600236,developer,17,2,15
Math,7600237,developer,17,2,15
Math,7600238,developer,17,2,15
Math,7600239,developer,17,2,15
Math,7600240,developer,17,2,15
Math,7600241,developer,17,2,15
Math,7600242,developer,17,2,15
Math,7600274,developer,17,2,15
Math,7600275,developer,17,2,15
Math,7600276,developer,17,2,15
Math,7600277,developer,17,2,15
Math,7600278,developer,17,2,15
Math,7600279,developer,17,2,15
Math,7600280,developer,17,2,15
Math,7600281,developer,17,2,15
Math,7600282,developer,17,2,15
Math,7700376,developer,346,1,345
Math,7800050,developer,116,1,115
Math,7800051,developer,116,1,115
Math,7800052,developer,116,1,115
Math,7800053,developer,116,1,115
Math,7800054,developer,116,1,115
Math,7800055,developer,116,1,115
Math,7800056,developer,116,1,115
Math,7800057,developer,116,1,115
Math,7800058,developer,116,1,115
Math,7800059,developer,116,1,115
Math,7800060,developer,116,1,115
Math,7800061,developer,116,1,115
Math,7800062,developer,116,1,115
Math,7800063,developer,116,1,115
Math,7800064,developer,116,1,115
Math,7800065,developer,116,1,115
Math,7901226,developer,409,2,407
Math,7901227,developer,409,4,405
Math,7901231,developer,409,3,406
Math,7901232,developer,409,3,406
Math,7901233,developer,409,2,407
Math,7901234,developer,409,3,406
Math,8001607,developer,36,1,35
Math,8001608,developer,36,1,35
Math,8001609,developer,36,1,35
Math,8001610,developer,36,1,35
Math,8001611,developer,36,1,35
Math,8001612,developer,36,1,35
Math,8001613,developer,36,1,35
Math,8100910,developer,35,2,33
Math,8100911,developer,35,2,33
Math,8100912,developer,35,2,33
Math,8100913,developer,35,2,33
Math,8100914,developer,35,2,33
Math,8100915,developer,35,2,33
Math,8100917,developer,35,2,33
Math,8100918,developer,35,2,33
Math,8100919,developer,35,2,33
Math,8100920,developer,35,2,33
Math,8100921,developer,35,1,34
Math,8100922,developer,35,2,33
Math,8100923,developer,35,2,33
Math,8100924,developer,35,2,33
Math,8100925,developer,35,1,34
Math,8100926,developer,35,2,33
Math,8100927,developer,35,1,34
Math,8100928,developer,35,1,34
Math,8100929,developer,35,2,33
Math,8100930,developer,35,1,34
Math,8100931,developer,35,2,33
Math,8102754,developer,35,3,32
Math,8102755,developer,35,3,32
Math,8102756,developer,35,1,34
Math,8102757,developer,35,1,34
Math,8102758,developer,35,1,34
Math,8200030,developer,14,12,2
Math,8200031,developer,14,2,12
Math,8200032,developer,14,13,1
Math,8200033,developer,14,1,13
Math,8200034,developer,14,6,8
Math,8200035,developer,14,1,13
Math,8200036,developer,14,13,1
Math,8300193,developer,17,1,16
Math,8300194,developer,17,11,6
Math,8300272,developer,17,1,16
Math,8300280,developer,17,11,6
Math,8300281,developer,17,10,7
Math,8300282,developer,17,8,9
Math,8300283,developer,17,11,6
Math,8400005,developer,5,4,1
Math,8400024,developer,5,2,3
Math,8400025,developer,5,4,1
Math,8400026,developer,5,4,1
Math,8400027,developer,5,2,3
Math,8500056,developer,92,10,82
Math,8500057,developer,92,17,75
Math,8500058,developer,92,16,76
Math,8500059,developer,92,1,91
Math,8600033,developer,12,8,4
Math,8600034,developer,12,2,10
Math,8700193,developer,16,15,1
Math,8700194,developer,16,15,1
Math,8700195,developer,16,15,1
Math,8700196,developer,16,8,8
Math,8700197,developer,16,15,1
Math,8700198,developer,16,13,3
Math,8700200,developer,16,12,4
Math,8700201,developer,16,12,4
Math,8700202,developer,16,12,4
Math,8700203,developer,16,1,15
Math,8800270,developer,15,9,6
Math,8800279,developer,15,1,14
Math,8800280,developer,15,8,7
Math,8800281,developer,15,3,12
Math,8800282,developer,15,3,12
Math,8800283,developer,15,1,14
Math,9000010,developer,7,2,5
Math,9100149,developer,56,1,55
Math,9100150,developer,56,1,55
Math,9100151,developer,56,1,55
Math,9100152,developer,56,1,55
Math,9100153,developer,56,1,55
Math,9100154,developer,56,1,55
Math,9100155,developer,56,1,55
Math,9100156,developer,56,1,55
Math,9200058,developer,203,14,189
Math,9200059,developer,203,15,188
Math,9200060,developer,203,15,188
Math,9200061,developer,203,8,195
Math,9200062,developer,203,14,189
Math,9200063,developer,203,10,193
Math,9200064,developer,203,10,193
Math,9200065,developer,203,8,195
Math,9200066,developer,203,12,191
Math,9200067,developer,203,11,192
Math,9200068,developer,203,2,201
Math,9200069,developer,203,14,189
Math,9200070,developer,203,14,189
Math,9200071,developer,203,9,194
Math,9200072,developer,203,9,194
Math,9200073,developer,203,9,194
Math,9200074,developer,203,9,194
Math,9200075,developer,203,9,194
Math,9200076,developer,203,9,194
Math,9200077,developer,203,11,192
Math,9200078,developer,203,9,194
Math,9200079,developer,203,9,194
Math,9200080,developer,203,9,194
Math,9200081,developer,203,9,194
Math,9200082,developer,203,9,194
Math,9200083,developer,203,14,189
Math,9200084,developer,203,11,192
Math,9200085,developer,203,9,194
Math,9200086,developer,203,11,192
Math,9200087,developer,203,11,192
Math,9200088,developer,203,11,192
Math,9200089,developer,203,9,194
Math,9200090,developer,203,9,194
Math,9200091,developer,203,9,194
Math,9200092,developer,203,9,194
Math,9200093,developer,203,2,201
Math,9200094,developer,203,1,202
Math,9200095,developer,203,1,202
Math,9200096,developer,203,1,202
Math,9200097,developer,203,1,202
Math,9200098,developer,203,1,202
Math,9200099,developer,203,1,202
Math,9200100,developer,203,1,202
Math,9200101,developer,203,1,202
Math,9200102,developer,203,1,202
Math,9200103,developer,203,1,202
Math,9200104,developer,203,1,202
Math,9200105,developer,203,1,202
Math,9200106,developer,203,1,202
Math,9200107,developer,203,1,202
Math,9200108,developer,203,1,202
Math,9200109,developer,203,1,202
Math,9200110,developer,203,1,202
Math,9200111,developer,203,1,202
Math,9200112,developer,203,1,202
Math,9200113,developer,203,1,202
Math,9200114,developer,203,1,202
Math,9200115,developer,203,1,202
Math,9200116,developer,203,1,202
Math,9200117,developer,203,1,202
Math,9200118,developer,203,1,202
Math,9200119,developer,203,1,202
Math,9200120,developer,203,1,202
Math,9200121,developer,203,1,202
Math,9200122,developer,203,1,202
Math,9200123,developer,203,1,202
Math,9200124,developer,203,1,202
Math,9200125,developer,203,1,202
Math,9200126,developer,203,1,202
Math,9200127,developer,203,1,202
Math,9200128,developer,203,1,202
Math,9200129,developer,203,2,201
Math,9200130,developer,203,1,202
Math,9200131,developer,203,1,202
Math,9200132,developer,203,2,201
Math,9200133,developer,203,2,201
Math,9200134,developer,203,2,201
Math,9200135,developer,203,2,201
Math,9200136,developer,203,2,201
Math,9200137,developer,203,2,201
Math,9200138,developer,203,2,201
Math,9200139,developer,203,2,201
Math,9200140,developer,203,2,201
Math,9200141,developer,203,1,202
Math,9200142,developer,203,1,202
Math,9200143,developer,203,1,202
Math,9200144,developer,203,2,201
Math,9200145,developer,203,2,201
Math,9200146,developer,203,1,202
Math,9200147,developer,203,2,201
Math,9200148,developer,203,1,202
Math,9200149,developer,203,1,202
Math,9200150,developer,203,1,202
Math,9200151,developer,203,2,201
Math,9200152,developer,203,1,202
Math,9200153,developer,203,1,202
Math,9200154,developer,203,2,201
Math,9200155,developer,203,2,201
Math,9200157,developer,203,9,194
Math,9200158,developer,203,7,196
Math,9200159,developer,203,1,202
Math,9200160,developer,203,1,202
Math,9200161,developer,203,9,194
Math,9200162,developer,203,1,202
Math,9200163,developer,203,5,198
Math,9200164,developer,203,1,202
Math,9200165,developer,203,5,198
Math,9200166,developer,203,5,198
Math,9200167,developer,203,7,196
Math,9200168,developer,203,7,196
Math,9200169,developer,203,5,198
Math,9200170,developer,203,5,198
Math,9200171,developer,203,5,198
Math,9200172,developer,203,3,200
Math,9200173,developer,203,8,195
Math,9200174,developer,203,8,195
Math,9200175,developer,203,8,195
Math,9200176,developer,203,6,197
Math,9200177,developer,203,7,196
Math,9200178,developer,203,5,198
Math,9200179,developer,203,5,198
Math,9200180,developer,203,4,199
Math,9200181,developer,203,2,201
Math,9200182,developer,203,3,200
Math,9200183,developer,203,2,201
Math,9200184,developer,203,1,202
Math,9200185,developer,203,1,202
Math,9200186,developer,203,1,202
Math,9200187,developer,203,2,201
Math,9200188,developer,203,2,201
Math,9200189,developer,203,2,201
Math,9200190,developer,203,1,202
Math,9200191,developer,203,1,202
Math,9200192,developer,203,2,201
Math,9200193,developer,203,2,201
Math,9200194,developer,203,1,202
Math,9200195,developer,203,2,201
Math,9200196,developer,203,2,201
Math,9200197,developer,203,2,201
Math,9200198,developer,203,1,202
Math,9200199,developer,203,1,202
Math,9200200,developer,203,1,202
Math,9200201,developer,203,2,201
Math,9200202,developer,203,1,202
Math,9200203,developer,203,2,201
Math,9200204,developer,203,1,202
Math,9200205,developer,203,1,202
Math,9200206,developer,203,1,202
Math,9200222,developer,203,2,201
Math,9200223,developer,203,6,197
Math,9200224,developer,203,2,201
Math,9200225,developer,203,1,202
Math,9300184,developer,202,2,200
Math,9300185,developer,202,1,201
Math,9300186,developer,202,3,199
Math,9300187,developer,202,2,200
Math,9300188,developer,202,1,201
Math,9300189,developer,202,2,200
Math,9300190,developer,202,2,200
Math,9300191,developer,202,2,200
Math,9300192,developer,202,2,200
Math,9300193,developer,202,1,201
Math,9300198,developer,202,1,201
Math,9300199,developer,202,1,201
Math,9300200,developer,202,1,201
Math,9300201,developer,202,1,201
Math,9300202,developer,202,2,200
Math,9300207,developer,202,1,201
Math,9300208,developer,202,1,201
Math,9400170,developer,202,22,180
Math,9400171,developer,202,27,175
Math,9400175,developer,202,2,200
Math,9400176,developer,202,31,171
Math,9400178,developer,202,1,201
Math,9400181,developer,202,31,171
Math,9500054,developer,22,1,21
Math,9500055,developer,22,1,21
Math,9500056,developer,22,1,21
Math,9500057,developer,22,1,21
Math,9500058,developer,22,1,21
Math,9600182,developer,149,1,148
Math,9600183,developer,149,25,124
Math,9600184,developer,149,1,148
Math,9600185,developer,149,25,124
Math,9600186,developer,149,2,147
Math,9600187,developer,149,25,124
Math,9600188,developer,149,1,148
Math,9600189,developer,149,1,148
Math,9700039,developer,59,2,57
Math,9700040,developer,59,27,32
Math,9700041,developer,59,28,31
Math,9700042,developer,59,2,57
Math,9700043,developer,59,3,56
Math,9700044,developer,59,1,58
Math,9700045,developer,59,2,57
Math,9700046,developer,59,1,58
Math,9800400,developer,113,3,110
Math,9801092,developer,113,3,110
Math,9900424,developer,290,57,233
Math,9900425,developer,290,1,289
Math,9900426,developer,290,57,233
Math,9900427,developer,290,1,289
Math,9900428,developer,290,1,289
Math,9900429,developer,290,1,289
Math,9900430,developer,290,57,233
Math,9900606,developer,290,1,289
Math,9900607,developer,290,1,289
Math,10000082,developer,48,3,45
Math,10000114,developer,48,2,46
Math,10000117,developer,48,2,46
Math,10100071,developer,70,22,48
Math,10100072,developer,70,22,48
Math,10100073,developer,70,2,68
Math,10100074,developer,70,22,48
Math,10100078,developer,70,2,68
Math,10100079,developer,70,2,68
Math,10100080,developer,70,22,48
Math,10200016,developer,30,6,24
Math,10200017,developer,30,6,24
Math,10200018,developer,30,6,24
Math,10200019,developer,30,6,24
Math,10200020,developer,30,6,24
Math,10200021,developer,30,6,24
Math,10200022,developer,30,6,24
Math,10200023,developer,30,6,24
Math,10200024,developer,30,6,24
Math,10200025,developer,30,6,24
Math,10200026,developer,30,6,24
Math,10200027,developer,30,6,24
Math,10200028,developer,30,6,24
Math,10200029,developer,30,6,24
Math,10200030,developer,30,6,24
Math,10200031,developer,30,6,24
Math,10200032,developer,30,6,24
Math,10200038,developer,30,6,24
Math,10200039,developer,30,6,24
Math,10200040,developer,30,6,24
Math,10200041,developer,30,6,24
Math,10200042,developer,30,6,24
Math,10200043,developer,30,6,24
Math,10200044,developer,30,6,24
Math,10200045,developer,30,6,24
Math,10200046,developer,30,6,24
Math,10200047,developer,30,6,24
Math,10200048,developer,30,6,24
Math,10200049,developer,30,6,24
Math,10200050,developer,30,6,24
Math,10200051,developer,30,6,24
Math,10200052,developer,30,6,24
Math,10200053,developer,30,6,24
Math,10200054,developer,30,6,24
Math,10200055,developer,30,6,24
Math,10200056,developer,30,6,24
Math,10200057,developer,30,6,24
Math,10200058,developer,30,6,24
Math,10200059,developer,30,6,24
Math,10200060,developer,30,6,24
Math,10300039,developer,20,1,19
Math,10300040,developer,20,1,19
Math,10300041,developer,20,1,19
Math,10300042,developer,20,1,19
Math,10300043,developer,20,1,19
Math,10300044,developer,20,1,19
Math,10500150,developer,9,1,8
Math,10500151,developer,9,1,8
Math,10500152,developer,9,5,4
Math,10500153,developer,9,4,5
Math,10500154,developer,9,4,5
Math,10500155,developer,9,5,4
Math,10500156,developer,9,4,5
Math,10500157,developer,9,5,4
Math,10500158,developer,9,5,4
Math,10500159,developer,9,5,4
Math,10500160,developer,9,3,6
Math,10500161,developer,9,6,3
Math,10500162,developer,9,5,4
Math,10500163,developer,9,5,4
Math,10600034,developer,16,2,14
Math,10600035,developer,16,1,15
Math,10600036,developer,16,1,15
Math,10600040,developer,16,2,14
Math,10600041,developer,16,1,15
Math,10600042,developer,16,1,15
Mockito,1,developer,964,26,938
Mockito,2,developer,30,3,27
Mockito,3,developer,965,9,956
Mockito,4,developer,1311,4,1307
Mockito,5,developer,25,1,24
Mockito,6,developer,1089,7,1082
Mockito,7,developer,47,1,46
Mockito,8,developer,46,1,45
Mockito,9,developer,1104,3,1101
Mockito,10,developer,1075,1,1074
Mockito,11,developer,902,2,900
Mockito,12,developer,20,10,10
Mockito,13,developer,746,1,745
Mockito,14,developer,732,1,731
Mockito,15,developer,23,1,22
Mockito,16,developer,653,1,652
Mockito,17,developer,656,1,655
Mockito,18,developer,1111,1,1110
Mockito,19,developer,1181,1,1180
Mockito,20,developer,1303,8,1295
Mockito,21,developer,17,1,16
Mockito,22,developer,567,1,566
Mockito,23,developer,1044,1,1043
Mockito,24,developer,1053,2,1051
Mockito,25,developer,1031,6,1025
Mockito,26,developer,783,5,778
Mockito,27,developer,1075,2,1073
Mockito,28,developer,28,1,27
Mockito,29,developer,58,1,57
Mockito,30,developer,982,1,981
Mockito,31,developer,782,1,781
Mockito,32,developer,955,1,954
Mockito,33,developer,690,2,688
Mockito,34,developer,611,2,609
Mockito,35,developer,632,4,628
Mockito,36,developer,804,2,802
Mockito,37,developer,303,2,301
Mockito,38,developer,102,2,100
Mockito,100063,developer,964,26,938
Mockito,100064,developer,964,8,956
Mockito,100065,developer,964,4,960
Mockito,100066,developer,964,26,938
Mockito,100067,developer,964,14,950
Mockito,100068,developer,964,1,963
Mockito,100069,developer,964,3,961
Mockito,100070,developer,964,15,949
Mockito,200001,developer,30,3,27
Mockito,200009,developer,30,1,29
Mockito,200010,developer,30,3,27
Mockito,200011,developer,30,9,21
Mockito,200012,developer,30,1,29
Mockito,200013,developer,30,3,27
Mockito,200014,developer,30,3,27
Mockito,300066,developer,965,7,958
Mockito,300067,developer,965,6,959
Mockito,300068,developer,965,7,958
Mockito,300069,developer,965,7,958
Mockito,300070,developer,965,7,958
Mockito,300076,developer,965,35,930
Mockito,300077,developer,965,35,930
Mockito,300078,developer,965,7,958
Mockito,300079,developer,965,7,958
Mockito,300080,developer,965,35,930
Mockito,400016,developer,1311,1,1310
Mockito,600002,developer,1089,2,1087
Mockito,600003,developer,1089,1,1088
Mockito,600004,developer,1089,1,1088
Mockito,600005,developer,1089,23,1066
Mockito,600006,developer,1089,1,1088
Mockito,600007,developer,1089,1,1088
Mockito,600008,developer,1089,1,1088
Mockito,600009,developer,1089,1,1088
Mockito,600010,developer,1089,14,1075
Mockito,600012,developer,1089,10,1079
Mockito,600013,developer,1089,6,1083
Mockito,600014,developer,1089,31,1058
Mockito,600015,developer,1089,5,1084
Mockito,600016,developer,1089,1,1088
Mockito,600017,developer,1089,4,1085
Mockito,600018,developer,1089,1,1088
Mockito,600019,developer,1089,4,1085
Mockito,600020,developer,1089,1,1088
Mockito,600021,developer,1089,4,1085
Mockito,600022,developer,1089,1,1088
Mockito,700072,developer,47,1,46
Mockito,800012,developer,46,1,45
Mockito,900001,developer,1104,3,1101
Mockito,900002,developer,1104,27,1077
Mockito,1000012,developer,1075,24,1051
Mockito,1000013,developer,1075,27,1048
Mockito,1000014,developer,1075,24,1051
Mockito,1000016,developer,1075,27,1048
Mockito,1000017,developer,1075,27,1048
Mockito,1100013,developer,902,1,901
Mockito,1100014,developer,902,2,900
Mockito,1100015,developer,902,1,901
Mockito,1200007,developer,20,1,19
Mockito,1300012,developer,746,276,470
Mockito,1300015,developer,746,1,745
Mockito,1400020,developer,732,200,532
Mockito,1400089,developer,732,185,547
Mockito,1400090,developer,732,185,547
Mockito,1400091,developer,732,1,731
Mockito,1500006,developer,23,1,22
Mockito,1500007,developer,23,11,12
Mockito,1600009,developer,653,2,651
Mockito,1600039,developer,653,2,651
Mockito,1600040,developer,653,1,652
Mockito,1700009,developer,656,13,643
Mockito,1700010,developer,656,8,648
Mockito,1700011,developer,656,15,641
Mockito,1700042,developer,656,20,636
Mockito,1700043,developer,656,20,636
Mockito,1700044,developer,656,18,638
Mockito,1700072,developer,656,20,636
Mockito,1800024,developer,1111,1,1110
Mockito,1800025,developer,1111,1,1110
Mockito,1900021,developer,1181,29,1152
Mockito,1900046,developer,1181,1,1180
Mockito,1900048,developer,1181,1,1180
Mockito,1900049,developer,1181,1,1180
Mockito,1900050,developer,1181,1,1180
Mockito,1900051,developer,1181,15,1166
Mockito,1900052,developer,1181,16,1165
Mockito,1900053,developer,1181,1,1180
Mockito,1900054,developer,1181,1,1180
Mockito,1900055,developer,1181,15,1166
Mockito,1900056,developer,1181,13,1168
Mockito,2100004,developer,17,3,14
Mockito,2100005,developer,17,2,15
Mockito,2100006,developer,17,2,15
Mockito,2100007,developer,17,2,15
Mockito,2100008,developer,17,2,15
Mockito,2100009,developer,17,2,15
Mockito,2100010,developer,17,2,15
Mockito,2100011,developer,17,2,15
Mockito,2100012,developer,17,2,15
Mockito,2200001,developer,567,1,566
Mockito,2200002,developer,567,98,469
Mockito,2200003,developer,567,1,566
Mockito,2200004,developer,567,1,566
Mockito,2200005,developer,567,143,424
Mockito,2300003,developer,1044,25,1019
Mockito,2300004,developer,1044,14,1030
Mockito,2300009,developer,1044,25,1019
Mockito,2300010,developer,1044,25,1019
Mockito,2300011,developer,1044,14,1030
Mockito,2300012,developer,1044,14,1030
Mockito,2300027,developer,1044,24,1020
Mockito,2300028,developer,1044,15,1029
Mockito,2400012,developer,1053,6,1047
Mockito,2400013,developer,1053,6,1047
Mockito,2400014,developer,1053,2,1051
Mockito,2400015,developer,1053,2,1051
Mockito,2400016,developer,1053,2,1051
Mockito,2400017,developer,1053,3,1050
Mockito,2400018,developer,1053,1,1052
Mockito,2500007,developer,1031,20,1011
Mockito,2500013,developer,1031,20,1011
Mockito,2500014,developer,1031,20,1011
Mockito,2500015,developer,1031,4,1027
Mockito,2500016,developer,1031,21,1010
Mockito,2500017,developer,1031,21,1010
Mockito,2500018,developer,1031,4,1027
Mockito,2500019,developer,1031,23,1008
Mockito,2500020,developer,1031,19,1012
Mockito,2600051,developer,783,6,777
Mockito,2600052,developer,783,6,777
Mockito,2600053,developer,783,6,777
Mockito,2700020,developer,1075,23,1052
Mockito,2800015,developer,28,14,14
Mockito,2800016,developer,28,1,27
Mockito,2900005,developer,58,1,57
Mockito,2900006,developer,58,3,55
Mockito,3000018,developer,982,6,976
Mockito,3100006,developer,782,4,778
Mockito,3100007,developer,782,2,780
Mockito,3100008,developer,782,4,778
Mockito,3100009,developer,782,2,780
Mockito,3100010,developer,782,4,778
Mockito,3100011,developer,782,4,778
Mockito,3100012,developer,782,2,780
Mockito,3100013,developer,782,4,778
Mockito,3100014,developer,782,2,780
Mockito,3200011,developer,955,11,944
Mockito,3300041,developer,690,367,323
Mockito,3300042,developer,690,22,668
Mockito,3300043,developer,690,417,273
Mockito,3300044,developer,690,417,273
Mockito,3300045,developer,690,8,682
Mockito,3300046,developer,690,367,323
Mockito,3300047,developer,690,16,674
Mockito,3300048,developer,690,414,276
Mockito,3300049,developer,690,409,281
Mockito,3300050,developer,690,276,414
Mockito,3300051,developer,690,16,674
Mockito,3300052,developer,690,367,323
Mockito,3300053,developer,690,26,664
Mockito,3400044,developer,611,2,609
Mockito,3400045,developer,611,10,601
Mockito,3400046,developer,611,10,601
Mockito,3400047,developer,611,2,609
Mockito,3400048,developer,611,133,478
Mockito,3500022,developer,632,7,625
Mockito,3500031,developer,632,15,617
Mockito,3500033,developer,632,3,629
Mockito,3600114,developer,804,2,802
Mockito,3600115,developer,804,29,775
Mockito,3600116,developer,804,2,802
Mockito,3700005,developer,303,2,301
Mockito,3700006,developer,303,2,301
Mockito,3700007,developer,303,9,294
Mockito,3700008,developer,303,2,301
Mockito,3800020,developer,102,2,100
Time,1,developer,3946,1,3945
Time,2,developer,3946,1,3945
Time,3,developer,1307,5,1302
Time,4,developer,770,1,769
Time,5,developer,1887,3,1884
Time,6,developer,2600,5,2595
Time,7,developer,2703,2,2701
Time,8,developer,3883,1,3882
Time,9,developer,3883,1,3882
Time,10,developer,371,2,369
Time,11,developer,8,1,7
Time,12,developer,1674,8,1666
Time,13,developer,971,1,970
Time,14,developer,3816,8,3808
Time,15,developer,2725,1,2724
Time,16,developer,2596,7,2589
Time,17,developer,3800,1,3799
Time,18,developer,2485,1,2484
Time,19,developer,3790,1,3789
Time,20,developer,2575,1,2574
Time,21,developer,3783,2,3781
Time,22,developer,1814,2,1812
Time,23,developer,3572,1,3571
Time,24,developer,1038,7,1031
Time,25,developer,3729,3,3726
Time,26,developer,3763,8,3755
Time,27,developer,738,1,737
Time,100032,developer,3946,140,3806
Time,100033,developer,3946,1,3945
Time,100034,developer,3946,140,3806
Time,100035,developer,3946,1,3945
Time,100036,developer,3946,1,3945
Time,100037,developer,3946,1,3945
Time,100038,developer,3946,1,3945
Time,100039,developer,3946,1,3945
Time,100048,developer,3946,3,3943
Time,100049,developer,3946,3,3943
Time,100050,developer,3946,3,3943
Time,100051,developer,3946,6,3940
Time,100052,developer,3946,3,3943
Time,100053,developer,3946,1,3945
Time,100423,developer,3946,6,3940
Time,200033,developer,3946,7,3939
Time,200034,developer,3946,137,3809
Time,200035,developer,3946,7,3939
Time,200399,developer,3946,1,3945
Time,200400,developer,3946,1,3945
Time,200401,developer,3946,1,3945
Time,200402,developer,3946,6,3940
Time,300058,developer,1307,1,1306
Time,300059,developer,1307,1,1306
Time,300060,developer,1307,1,1306
Time,300061,developer,1307,1,1306
Time,300064,developer,1307,1,1306
Time,300065,developer,1307,1,1306
Time,300066,developer,1307,1,1306
Time,300067,developer,1307,1,1306
Time,300070,developer,1307,1,1306
Time,300071,developer,1307,1,1306
Time,300074,developer,1307,1,1306
Time,300075,developer,1307,1,1306
Time,300076,developer,1307,1,1306
Time,300077,developer,1307,1,1306
Time,300080,developer,1307,1,1306
Time,300081,developer,1307,1,1306
Time,300082,developer,1307,1,1306
Time,300083,developer,1307,1,1306
Time,300088,developer,1307,1,1306
Time,300089,developer,1307,1,1306
Time,300090,developer,1307,1,1306
Time,300091,developer,1307,1,1306
Time,300094,developer,1307,12,1295
Time,300095,developer,1307,13,1294
Time,300099,developer,1307,1,1306
Time,300103,developer,1307,1,1306
Time,300107,developer,1307,1,1306
Time,400204,developer,770,25,745
Time,500517,developer,1887,11,1876
Time,500518,developer,1887,9,1878
Time,500519,developer,1887,11,1876
Time,500520,developer,1887,10,1877
Time,500521,developer,1887,12,1875
Time,500522,developer,1887,11,1876
Time,500523,developer,1887,12,1875
Time,500524,developer,1887,11,1876
Time,500525,developer,1887,10,1877
Time,500526,developer,1887,14,1873
Time,500527,developer,1887,6,1881
Time,500528,developer,1887,4,1883
Time,500529,developer,1887,7,1880
Time,500530,developer,1887,6,1881
Time,500531,developer,1887,6,1881
Time,500532,developer,1887,6,1881
Time,500533,developer,1887,6,1881
Time,500534,developer,1887,6,1881
Time,500535,developer,1887,6,1881
Time,500536,developer,1887,6,1881
Time,500537,developer,1887,6,1881
Time,500538,developer,1887,6,1881
Time,500539,developer,1887,6,1881
Time,500540,developer,1887,6,1881
Time,500541,developer,1887,6,1881
Time,500542,developer,1887,6,1881
Time,500543,developer,1887,6,1881
Time,500544,developer,1887,6,1881
Time,500545,developer,1887,6,1881
Time,500546,developer,1887,10,1877
Time,500547,developer,1887,10,1877
Time,500548,developer,1887,10,1877
Time,500549,developer,1887,10,1877
Time,500550,developer,1887,10,1877
Time,500551,developer,1887,10,1877
Time,500552,developer,1887,10,1877
Time,500553,developer,1887,10,1877
Time,500554,developer,1887,10,1877
Time,500555,developer,1887,2,1885
Time,500556,developer,1887,10,1877
Time,600021,developer,2600,1,2599
Time,600237,developer,2600,2,2598
Time,600238,developer,2600,2,2598
Time,600239,developer,2600,1,2599
Time,600240,developer,2600,1,2599
Time,600241,developer,2600,1,2599
Time,600242,developer,2600,1,2599
Time,600243,developer,2600,1,2599
Time,600244,developer,2600,2,2598
Time,600245,developer,2600,2,2598
Time,600246,developer,2600,2,2598
Time,600247,developer,2600,2,2598
Time,600248,developer,2600,1,2599
Time,600249,developer,2600,1,2599
Time,600250,developer,2600,1,2599
Time,600251,developer,2600,2,2598
Time,600252,developer,2600,2,2598
Time,600253,developer,2600,2,2598
Time,600254,developer,2600,2,2598
Time,700114,developer,2703,17,2686
Time,800048,developer,3883,1,3882
Time,800051,developer,3883,2,3881
Time,800054,developer,3883,1,3882
Time,800055,developer,3883,1,3882
Time,800056,developer,3883,1,3882
Time,800058,developer,3883,1,3882
Time,800059,developer,3883,1,3882
Time,800060,developer,3883,1,3882
Time,800061,developer,3883,1,3882
Time,800063,developer,3883,1,3882
Time,800065,developer,3883,1,3882
Time,800066,developer,3883,7,3876
Time,800067,developer,3883,1,3882
Time,800069,developer,3883,1,3882
Time,800080,developer,3883,6,3877
Time,800081,developer,3883,5,3878
Time,800082,developer,3883,1,3882
Time,800083,developer,3883,6,3877
Time,800084,developer,3883,5,3878
Time,900038,developer,3883,6,3877
Time,900041,developer,3883,1,3882
Time,900045,developer,3883,1,3882
Time,900060,developer,3883,20,3863
Time,900061,developer,3883,20,3863
Time,900062,developer,3883,20,3863
Time,900063,developer,3883,21,3862
Time,900064,developer,3883,21,3862
Time,900065,developer,3883,20,3863
Time,900070,developer,3883,6,3877
Time,900071,developer,3883,5,3878
Time,900072,developer,3883,1,3882
Time,900073,developer,3883,6,3877
Time,900074,developer,3883,5,3878
Time,900076,developer,3883,18,3865
Time,900077,developer,3883,2,3881
Time,900079,developer,3883,17,3866
Time,900084,developer,3883,1,3882
Time,900086,developer,3883,1,3882
Time,1000026,developer,371,12,359
Time,1100001,developer,8,1,7
Time,1200007,developer,1674,2,1672
Time,1200009,developer,1674,4,1670
Time,1200010,developer,1674,2,1672
Time,1200011,developer,1674,4,1670
Time,1200012,developer,1674,4,1670
Time,1200013,developer,1674,2,1672
Time,1200014,developer,1674,4,1670
Time,1200015,developer,1674,4,1670
Time,1200016,developer,1674,4,1670
Time,1200017,developer,1674,6,1668
Time,1200018,developer,1674,6,1668
Time,1200019,developer,1674,6,1668
Time,1200020,developer,1674,6,1668
Time,1200021,developer,1674,6,1668
Time,1200022,developer,1674,6,1668
Time,1200024,developer,1674,2,1672
Time,1200025,developer,1674,3,1671
Time,1200026,developer,1674,3,1671
Time,1200027,developer,1674,3,1671
Time,1200390,developer,1674,2,1672
Time,1200392,developer,1674,4,1670
Time,1200393,developer,1674,2,1672
Time,1200394,developer,1674,4,1670
Time,1200395,developer,1674,4,1670
Time,1200396,developer,1674,2,1672
Time,1200397,developer,1674,4,1670
Time,1200398,developer,1674,4,1670
Time,1200399,developer,1674,4,1670
Time,1200400,developer,1674,6,1668
Time,1200401,developer,1674,6,1668
Time,1200402,developer,1674,6,1668
Time,1200403,developer,1674,6,1668
Time,1200404,developer,1674,6,1668
Time,1200405,developer,1674,6,1668
Time,1200407,developer,1674,2,1672
Time,1200408,developer,1674,3,1671
Time,1200409,developer,1674,3,1671
Time,1200410,developer,1674,3,1671
Time,1300306,developer,971,2,969
Time,1300307,developer,971,2,969
Time,1300308,developer,971,2,969
Time,1300309,developer,971,2,969
Time,1300310,developer,971,2,969
Time,1300311,developer,971,2,969
Time,1300351,developer,971,1,970
Time,1300373,developer,971,1,970
Time,1300374,developer,971,15,956
Time,1300375,developer,971,1,970
Time,1300376,developer,971,1,970
Time,1300377,developer,971,1,970
Time,1300378,developer,971,3,968
Time,1300379,developer,971,1,970
Time,1300380,developer,971,1,970
Time,1300381,developer,971,3,968
Time,1300382,developer,971,15,956
Time,1300383,developer,971,1,970
Time,1400104,developer,3816,8,3808
Time,1400105,developer,3816,8,3808
Time,1400106,developer,3816,21,3795
Time,1400107,developer,3816,8,3808
Time,1400108,developer,3816,8,3808
Time,1400109,developer,3816,8,3808
Time,1400110,developer,3816,8,3808
Time,1400111,developer,3816,4,3812
Time,1400112,developer,3816,8,3808
Time,1400113,developer,3816,15,3801
Time,1400114,developer,3816,17,3799
Time,1400115,developer,3816,17,3799
Time,1400116,developer,3816,17,3799
Time,1400117,developer,3816,17,3799
Time,1400118,developer,3816,17,3799
Time,1400119,developer,3816,17,3799
Time,1400120,developer,3816,17,3799
Time,1400121,developer,3816,17,3799
Time,1400122,developer,3816,17,3799
Time,1400123,developer,3816,2,3814
Time,1400124,developer,3816,17,3799
Time,1400125,developer,3816,15,3801
Time,1400126,developer,3816,17,3799
Time,1400127,developer,3816,17,3799
Time,1400128,developer,3816,17,3799
Time,1400129,developer,3816,2,3814
Time,1400130,developer,3816,14,3802
Time,1400131,developer,3816,2,3814
Time,1400132,developer,3816,15,3801
Time,1400133,developer,3816,14,3802
Time,1400134,developer,3816,15,3801
Time,1400135,developer,3816,17,3799
Time,1400136,developer,3816,17,3799
Time,1400137,developer,3816,17,3799
Time,1400138,developer,3816,3,3813
Time,1400139,developer,3816,15,3801
Time,1400140,developer,3816,17,3799
Time,1400141,developer,3816,17,3799
Time,1400142,developer,3816,17,3799
Time,1400143,developer,3816,17,3799
Time,1400144,developer,3816,17,3799
Time,1400145,developer,3816,17,3799
Time,1400146,developer,3816,17,3799
Time,1400147,developer,3816,17,3799
Time,1500086,developer,2725,13,2712
Time,1500087,developer,2725,1,2724
Time,1700380,developer,3800,2,3798
Time,1700381,developer,3800,2,3798
Time,1700382,developer,3800,2,3798
Time,1700384,developer,3800,2,3798
Time,1700385,developer,3800,2,3798
Time,1700386,developer,3800,2,3798
Time,1700387,developer,3800,2,3798
Time,1700388,developer,3800,2,3798
Time,1700389,developer,3800,2,3798
Time,1700390,developer,3800,2,3798
Time,1700391,developer,3800,2,3798
Time,1700392,developer,3800,2,3798
Time,1700393,developer,3800,2,3798
Time,1700394,developer,3800,2,3798
Time,1700395,developer,3800,2,3798
Time,1700396,developer,3800,3,3797
Time,1700397,developer,3800,2,3798
Time,1700398,developer,3800,2,3798
Time,1700400,developer,3800,2,3798
Time,1700401,developer,3800,2,3798
Time,1700402,developer,3800,2,3798
Time,1700403,developer,3800,2,3798
Time,1700404,developer,3800,2,3798
Time,1700405,developer,3800,2,3798
Time,1700406,developer,3800,2,3798
Time,1700407,developer,3800,2,3798
Time,1700408,developer,3800,2,3798
Time,1700409,developer,3800,2,3798
Time,1700410,developer,3800,1,3799
Time,1700411,developer,3800,2,3798
Time,1700412,developer,3800,2,3798
Time,1700413,developer,3800,2,3798
Time,1700414,developer,3800,1,3799
Time,1700415,developer,3800,1,3799
Time,1700416,developer,3800,2,3798
Time,1700417,developer,3800,1,3799
Time,1700418,developer,3800,1,3799
Time,1700419,developer,3800,2,3798
Time,1700420,developer,3800,2,3798
Time,1700421,developer,3800,1,3799
Time,1700422,developer,3800,2,3798
Time,1700423,developer,3800,2,3798
Time,1700424,developer,3800,2,3798
Time,1700425,developer,3800,2,3798
Time,1700426,developer,3800,2,3798
Time,1700427,developer,3800,2,3798
Time,1700428,developer,3800,2,3798
Time,1700429,developer,3800,2,3798
Time,1700430,developer,3800,2,3798
Time,1700431,developer,3800,2,3798
Time,1700432,developer,3800,2,3798
Time,1700433,developer,3800,2,3798
Time,1800063,developer,2485,1,2484
Time,1800064,developer,2485,1,2484
Time,1800065,developer,2485,1,2484
Time,1800066,developer,2485,1,2484
Time,1800067,developer,2485,1,2484
Time,1800068,developer,2485,1,2484
Time,1800069,developer,2485,1,2484
Time,1800070,developer,2485,1,2484
Time,1800071,developer,2485,1,2484
Time,1800072,developer,2485,1,2484
Time,1900286,developer,3790,1,3789
Time,1900287,developer,3790,6,3784
Time,1900288,developer,3790,1,3789
Time,2001156,developer,2575,9,2566
Time,2001157,developer,2575,1,2574
Time,2001158,developer,2575,9,2566
Time,2001159,developer,2575,1,2574
Time,2001160,developer,2575,9,2566
Time,2001161,developer,2575,9,2566
Time,2001162,developer,2575,1,2574
Time,2001163,developer,2575,5,2570
Time,2001164,developer,2575,9,2566
Time,2001165,developer,2575,1,2574
Time,2001166,developer,2575,9,2566
Time,2001167,developer,2575,9,2566
Time,2100022,developer,3783,24,3759
Time,2100023,developer,3783,20,3763
Time,2100024,developer,3783,20,3763
Time,2100025,developer,3783,20,3763
Time,2100026,developer,3783,20,3763
Time,2100027,developer,3783,20,3763
Time,2100028,developer,3783,24,3759
Time,2100029,developer,3783,20,3763
Time,2100030,developer,3783,20,3763
Time,2100031,developer,3783,20,3763
Time,2100042,developer,3783,20,3763
Time,2100043,developer,3783,12,3771
Time,2100044,developer,3783,24,3759
Time,2100045,developer,3783,6,3777
Time,2100046,developer,3783,24,3759
Time,2100047,developer,3783,6,3777
Time,2100048,developer,3783,24,3759
Time,2100049,developer,3783,12,3771
Time,2100050,developer,3783,24,3759
Time,2100051,developer,3783,24,3759
Time,2100052,developer,3783,20,3763
Time,2100053,developer,3783,5,3778
Time,2100054,developer,3783,5,3778
Time,2100055,developer,3783,5,3778
Time,2100056,developer,3783,20,3763
Time,2100057,developer,3783,21,3762
Time,2100058,developer,3783,14,3769
Time,2100059,developer,3783,21,3762
Time,2100060,developer,3783,6,3777
Time,2100061,developer,3783,21,3762
Time,2100062,developer,3783,20,3763
Time,2200062,developer,1814,50,1764
Time,2200063,developer,1814,50,1764
Time,2200064,developer,1814,35,1779
Time,2200065,developer,1814,50,1764
Time,2200066,developer,1814,50,1764
Time,2200067,developer,1814,50,1764
Time,2200068,developer,1814,50,1764
Time,2200069,developer,1814,50,1764
Time,2200070,developer,1814,31,1783
Time,2200071,developer,1814,50,1764
Time,2200072,developer,1814,33,1781
Time,2200073,developer,1814,50,1764
Time,2200074,developer,1814,33,1781
Time,2300148,developer,3572,1,3571
Time,2300149,developer,3572,1,3571
Time,2300158,developer,3572,1,3571
Time,2300161,developer,3572,1,3571
Time,2300163,developer,3572,1,3571
Time,2300165,developer,3572,1,3571
Time,2300166,developer,3572,1,3571
Time,2300168,developer,3572,1,3571
Time,2300170,developer,3572,1,3571
Time,2400071,developer,1038,7,1031
Time,2400072,developer,1038,10,1028
Time,2400075,developer,1038,7,1031
Time,2400076,developer,1038,7,1031
Time,2400077,developer,1038,10,1028
Time,2400078,developer,1038,7,1031
Time,2400079,developer,1038,7,1031
Time,2400080,developer,1038,7,1031
Time,2400081,developer,1038,7,1031
Time,2400082,developer,1038,7,1031
Time,2400083,developer,1038,7,1031
Time,2500258,developer,3729,3,3726
Time,2500259,developer,3729,3,3726
Time,2500260,developer,3729,3,3726
Time,2500261,developer,3729,3,3726
Time,2500262,developer,3729,3,3726
Time,2500263,developer,3729,3,3726
Time,2500264,developer,3729,5,3724
Time,2500265,developer,3729,3,3726
Time,2500266,developer,3729,410,3319
Time,2500267,developer,3729,16,3713
Time,2500268,developer,3729,40,3689
Time,2500269,developer,3729,1,3728
Time,2500270,developer,3729,3,3726
Time,2500271,developer,3729,547,3182
Time,2500272,developer,3729,4,3725
Time,2600197,developer,3763,2,3761
Time,2600200,developer,3763,12,3751
Time,2600243,developer,3763,5,3758
Time,2600257,developer,3763,2,3761
Time,2700203,developer,738,97,641
Time,2700204,developer,738,97,641
Time,2700205,developer,738,1,737
Time,2700206,developer,738,97,641
Chart,1500082,developer,197,1,196
Chart,1500110,developer,197,1,196
Math,1701597,developer,81,1,80
Math,1701598,developer,81,1,80
Math,1701599,developer,81,1,80
Math,1701600,developer,81,1,80
Math,1701601,developer,81,1,80
Math,1701602,developer,81,1,80
Math,3801268,developer,17,1,16
Math,3801269,developer,17,1,16
Math,3801270,developer,17,1,16
Math,3801271,developer,17,1,16
Math,3801272,developer,17,1,16
Math,3801273,developer,17,1,16
Math,3801274,developer,17,1,16
Math,3801275,developer,17,1,16
Math,3801276,developer,17,1,16
Math,3801277,developer,17,1,16
Math,3801278,developer,17,1,16
Math,3801279,developer,17,1,16
Math,5400083,developer,63,1,62
Math,5400084,developer,63,1,62
Math,5400085,developer,63,1,62
Math,5400086,developer,63,1,62
Math,5400087,developer,63,1,62
Math,5400088,developer,63,1,62
Math,5400089,developer,63,1,62
Math,5400090,developer,63,1,62
Math,5400091,developer,63,1,62
Math,5402478,developer,63,20,43
Math,5402479,developer,63,13,50
Math,5402480,developer,63,12,51
Math,5402481,developer,63,19,44
Math,5402482,developer,63,1,62
Math,5402483,developer,63,1,62
Math,5402484,developer,63,1,62
Math,5402485,developer,63,1,62
Math,5402486,developer,63,1,62
Math,5402487,developer,63,1,62
Math,5402488,developer,63,1,62
Math,5402489,developer,63,1,62
Math,5402490,developer,63,1,62
Math,5402491,developer,63,12,51
Math,5402492,developer,63,19,44
Math,5402493,developer,63,12,51
Math,5908273,developer,1513,1,1512
Math,5908274,developer,1513,1,1512
Math,5908275,developer,1513,1,1512
Math,5908276,developer,1513,1,1512
